batch_start_ep,batch_end_ep,new_states,batch_seconds,ema_seconds,states_per_second,cumulative_states,coverage_percent,q_updates
0,120,33396,156.61144280433655,0,213.2411233943071,33396,5.159436410826845,80551
120,182,8377,80.34833145141602,156.61144280433655,104.25854337828154,41773,6.453621307625756,41505
182,214,3903,41.73238468170166,133.7325093984604,93.52449014760815,45676,7.056606105549376,21536
214,230,1659,21.490715742111206,106.13247198343277,77.1961259879855,47335,7.312909405512298,10732
230,240,1027,14.210204601287842,80.73994511103629,72.2720065485141,48362,7.471573353108392,6673
240,250,838,12.917182922363281,60.781022958111755,64.87482642590638,49200,7.601038190582128,6704
250,260,1028,13.889393329620361,46.42187094738721,74.01331185629965,50228,7.759856630824373,6632
260,270,871,15.551718473434448,36.66212766205716,56.006672284342606,51099,7.89441972562106,6715
270,280,928,11.828361749649048,30.329004905470345,78.4554970199093,52027,8.037788901248302,6657
280,290,859,12.09552264213562,24.778811958723956,71.0180143028803,52886,8.170498084291188,6703
290,300,850,12.647526741027832,20.973825163747456,67.20681579922262,53736,8.301816833518725,6753
300,310,891,13.993814706802368,18.475935636931567,63.67098740895051,54627,8.439469781238413,6729
310,320,987,14.840028285980225,17.131299357892807,66.50930719131078,55614,8.591954022988507,6711
320,330,768,13.920519351959229,16.443918036319033,55.170355399987905,56382,8.710604375231739,6749
330,340,804,13.994523048400879,15.686898431011091,57.45104690022796,57186,8.834816462736374,6705
340,350,733,14.358953714370728,15.179185816228028,51.04828768034811,57919,8.948059572364356,6728
350,360,755,17.265388250350952,14.933116185670837,43.72910640944626,58674,9.064701520207638,6795
360,370,737,13.082170724868774,15.632797805074869,56.33621632830302,59411,9.17856260042022,6702
370,380,784,11.638659715652466,14.86760968101304,67.36170823394924,60195,9.299684835001854,6744
380,390,777,11.017117261886597,13.898924691404867,70.52661613106446,60972,9.419725621060437,6660
390,400,637,11.799975633621216,13.034382462549384,53.98316231984585,61609,9.518137436658016,6694
400,410,728,13.114874362945557,12.664060413870933,55.509490968275934,62337,9.630608083055247,6642
410,420,838,12.782352924346924,12.79930459859332,65.55913492294809,63175,9.760072920528982,6701
420,430,515,11.277588129043579,12.794219096319399,45.66579255308162,63690,9.839636633296255,6729
430,440,718,10.878037691116333,12.339229806136652,66.00455159172343,64408,9.950562353231986,6731
440,450,553,10.75436019897461,11.900872171630557,51.421004110753756,64961,10.03599678655296,6765
450,460,531,14.126371622085571,11.556918579833772,37.58927021074679,65492,10.118032381658633,6654
460,470,569,11.63252568244934,12.32775449250931,48.914570707415926,66061,10.205938697318008,6744
470,480,402,11.74062967300415,12.11918584949132,34.240071546106236,66463,10.268044741070327,6618
480,490,657,11.433950185775757,12.005618996545168,57.460456738505954,67120,10.369546409590903,6679
490,500,504,12.619365453720093,11.834118353314343,39.93861671162116,67624,10.447410703250526,6715
500,510,483,14.119887351989746,12.069692483436068,34.2070717676042,68107,10.522030651340996,6717
510,520,412,12.662628889083862,12.68475094400217,32.536687571660174,68519,10.585681621554814,6696
520,530,457,12.297007322311401,12.678114327526677,37.163513692541265,68976,10.656284760845383,6639
530,540,510,12.140992879867554,12.563782225962093,42.00644914681505,69486,10.735076010381906,6643
540,550,532,15.141767978668213,12.43694542213373,35.1346025609086,70018,10.817266098133729,6739
550,560,446,13.961628675460815,13.248392189094075,31.944697167308053,70464,10.886169818316647,6686
560,570,509,14.204948663711548,13.462363135004097,35.83258285897991,70973,10.964806575207021,6742
570,580,547,13.90873122215271,13.68513879361633,39.32781439681445,71520,11.049314052651093,6701
580,590,575,15.993909358978271,13.752216522177243,35.95118536027094,72095,11.138147324187369,6622
590,600,510,13.560028553009033,14.42472437321755,37.61054027329674,72605,11.21693857372389,6700
600,610,481,11.54751443862915,14.165315627154992,41.65398558766395,73086,11.291249536522061,6653
610,620,381,14.17197561264038,13.379975270597239,26.884042875446063,73467,11.350111234705228,6668
620,630,345,13.677004098892212,13.61757537321018,25.224822446894184,73812,11.403411197626994,6630
630,640,374,13.163376092910767,13.635403990914789,28.412163973755977,74186,11.461191447287108,6723
640,650,430,11.19692087173462,13.49379562151358,38.403415092937486,74616,11.527623285131627,6710
650,660,461,11.730552911758423,12.80473319657989,39.299085343019485,75077,11.598844395006799,6645
660,670,355,11.496901750564575,12.48247911113345,30.877884120612503,75432,11.653689284390063,6718
670,680,369,11.279825687408447,12.186805902962787,32.71327148361086,75801,11.710697070819428,6753
680,690,454,12.175052881240845,11.914711838296483,37.28936575704874,76255,11.780836732171549,6676
690,700,368,12.394302606582642,11.992814151179791,29.691061424025133,76623,11.837690025954764,6632
700,710,446,10.707377433776855,12.113260687800645,41.65352372776876,77069,11.906593746137684,6675
710,720,373,11.561546802520752,11.691495711593507,32.26211910664715,77442,11.96421950315165,6718
720,730,465,10.969557285308838,11.652511038871681,42.39004254280699,77907,12.03605858361142,6683
730,740,347,12.895054340362549,11.447624912802828,26.90954150645665,78254,12.089667531825485,6697
740,750,483,11.503245115280151,11.881853741070744,41.98815161805208,78737,12.164287479915956,6690
750,760,334,11.983758687973022,11.768271153333567,27.871055208680442,79071,12.21588802373007,6733
760,770,352,12.387305736541748,11.832917413725403,28.4161873038802,79423,12.270269435174885,6693
770,780,442,11.415982246398926,11.999233910570306,38.71764956006524,79865,12.338555184773204,6676
780,790,402,11.571260452270508,11.82425841131889,34.74124548990856,80267,12.400661228525522,6679
790,800,352,11.686316728591919,11.748359023604376,30.12069655264361,80619,12.455042639970337,6716
800,810,356,10.867133855819702,11.72974633510064,32.75932777890193,80975,12.510042021999753,6773
810,820,387,11.825928211212158,11.470962591316358,32.72470397994514,81362,12.569830676059821,6691
820,830,345,11.116213321685791,11.577452277285097,31.035748416861093,81707,12.623130638981584,6706
830,840,361,11.273797273635864,11.439080590605304,32.021154118516044,82068,12.67890248424175,6672
840,850,290,11.062257528305054,11.389495595514472,26.215263860742308,82358,12.723705351625261,6740
850,860,278,11.274872303009033,11.291324175351646,24.65659854309902,82636,12.766654307254974,6655
860,870,293,11.876777410507202,11.286388613648862,24.669991688215646,82929,12.811920652576939,6699
870,880,424,11.610451221466064,11.463505252706364,36.51882187111597,83353,12.877425534544557,6678
880,890,314,12.343065738677979,11.507589043334274,25.439384886046263,83667,12.925936225435668,6695
890,900,305,12.217336416244507,11.758232051937386,24.96452496752595,83972,12.973056482511433,6748
900,910,317,10.976669549942017,11.895963361229521,28.879433653140676,84289,13.022030651340996,6692
910,920,289,11.694240093231201,11.620175217843268,24.713020914225755,84578,13.06667902607836,6726
920,930,309,12.10628628730774,11.642394680459647,25.52392968964862,84887,13.114417253738722,6688
930,940,292,11.946801662445068,11.781562162514074,24.441688097820016,85179,13.159529106414535,6630
940,950,201,12.345710515975952,11.831134012493372,16.280958454347054,85380,13.190582128290693,6741
950,960,273,11.318094968795776,11.985506963538146,24.120667016195455,85653,13.232758620689655,6680
960,970,291,11.344815015792847,11.785283365115435,25.65048434856856,85944,13.277715980719318,6678
970,980,314,10.454903364181519,11.653142860318658,30.03375440807645,86258,13.326226671610431,6704
980,990,308,10.953468084335327,11.293671011477516,28.11894804719193,86566,13.373810406624646,6680
990,1000,290,11.567142248153687,11.191610133334859,25.071015275729746,86856,13.418613274008157,6670
1000,1010,278,13.858546257019043,11.304269767780506,20.059824085747756,87134,13.461562229637869,6711
1010,1020,413,12.13931941986084,12.070552714552067,34.02167664558698,87547,13.525367692497836,6714
1020,1030,139,11.697845935821533,12.091182726144698,11.882529549679704,87686,13.546842170312692,6674
1030,1040,260,12.077181339263916,11.973181689047749,21.528202044521638,87946,13.587010258311704,6661
1040,1050,296,11.975815773010254,12.004381584112599,24.716479078368213,88242,13.632740081572118,6702
1050,1060,257,11.611005783081055,11.995811840781895,22.134172077882077,88499,13.672444691632679,6720
1060,1070,268,10.460385084152222,11.880370023471642,25.620471698123957,88767,13.71384872080089,6715
1070,1080,193,9.824756145477295,11.454374541675815,19.644253469725573,88960,13.743665801507849,6655
1080,1090,200,11.230567455291748,10.965489022816257,17.80853913181045,89160,13.774564330737856,6776
1090,1100,253,12.470757484436035,11.045012552558903,20.287460510378246,89413,13.813650970213818,6711
1100,1110,223,10.646896839141846,11.472736032122043,20.945070039579168,89636,13.848102830305278,6727
1110,1120,276,11.22502851486206,11.224984274227984,24.587910813284168,89912,13.89074280064269,6703
1120,1130,332,11.97932505607605,11.224997546418207,27.71441616667759,90244,13.942034359164504,6774
1130,1140,202,11.851588487625122,11.45129579931556,17.044128743663265,90446,13.973241873686812,6744
1140,1150,238,12.8439302444458,11.571383605808428,18.53015357996982,90684,14.010011123470523,6673
1150,1160,268,11.373416662216187,11.953147597399639,23.563719501311088,90952,14.051415152638736,6700
1160,1170,256,11.227882146835327,11.779228316844604,22.800381821976618,91208,14.090965270053147,6725
1170,1180,217,11.744037389755249,11.61382446584182,18.477461608671053,91425,14.124490174267704,6652
1180,1190,212,12.029184103012085,11.652888343015848,17.623805420595033,91637,14.157242615251514,6675
1190,1200,253,10.864264011383057,11.765777071014718,23.287357499313224,91890,14.196329254727475,6674
1200,1210,196,11.069692134857178,11.495323153125218,17.70600280587919,92086,14.226609813372884,6703
1210,1220,228,12.344533920288086,11.367633847644804,18.46971311126497,92314,14.261834136695093,6656
1220,1230,159,10.681144714355469,11.660703869437787,14.886044918603513,92473,14.286398467432951,6701
1230,1240,253,11.261711597442627,11.36683612291309,22.465501607895256,92726,14.32548510690891,6709
1240,1250,283,10.615818500518799,11.33529876527195,26.658330677579848,93009,14.369206525769373,6754
1250,1260,189,12.495357275009155,11.119454685846005,15.125617926748038,93198,14.39840563589173,6669
1260,1270,263,11.155735731124878,11.53222546259495,23.575316441588082,93461,14.439037201829194,6703
1270,1280,166,11.388923645019531,11.419278543153927,14.575565275002361,93627,14.4646829810901,6674
1280,1290,154,10.240572452545166,11.410172073713609,15.03822180973147,93781,14.488474848597207,6675
1290,1300,269,11.720210313796997,11.059292187363075,22.951806563004588,94050,14.53003337041157,6723
1300,1310,245,11.863203048706055,11.257567625293252,20.65209530631128,94295,14.567884068718328,6657
1310,1320,209,11.095548152923584,11.439258252317092,18.836383486374242,94504,14.600173031763688,6697
1320,1330,140,11.542203426361084,11.33614522249904,12.129399805955236,94644,14.621802002224694,6693
1330,1340,218,11.326226949691772,11.397962683657653,19.24736286570106,94862,14.655481399085405,6728
1340,1350,242,11.654101848602295,11.376441963467888,20.765220962010353,95104,14.692868619453714,6679
1350,1360,267,13.221360921859741,11.45973992900821,20.194592794040698,95371,14.734118155975775,6744
1360,1370,262,12.780264616012573,11.988226226863668,20.500358002895847,95633,14.774595229267087,6684
1370,1380,261,12.261551141738892,12.22583774360834,21.28605076004975,95894,14.814917809912249,6712
1380,1390,263,10.804392099380493,12.236551763047505,24.341952567149058,96157,14.85554937584971,6670
1390,1400,224,11.177773475646973,11.8069038639474,20.03976914436753,96381,14.89015572858732,6715
1400,1410,201,12.047056436538696,11.618164747457271,16.68457361836269,96582,14.921208750463478,6645
1410,1420,201,10.80534052848816,11.7468322541817,18.60191258850804,96783,14.952261772339636,6694
1420,1430,241,10.537958145141602,11.464384736473637,22.86970556161396,97024,14.989494500061799,6695
1430,1440,136,11.002636432647705,11.186456759074026,12.360673810547112,97160,15.010505499938203,6681
1440,1450,189,12.14547085762024,11.131310661146129,15.56135634555648,97349,15.03970461006056,6762
1450,1460,89,11.585001230239868,11.43555872008836,7.682347047809269,97438,15.053454455567916,6721
1460,1470,138,12.216352701187134,11.480391473133812,11.296333969351567,97576,15.074774440736622,6700
1470,1480,143,10.767349243164062,11.70117984154981,13.280891774805887,97719,15.096866889136077,6670
1480,1490,194,12.026857137680054,11.421030662034084,16.13056493306131,97913,15.126838462489186,6736
1490,1500,207,11.977547407150269,11.602778604727874,17.282336104670865,98120,15.158818440242245,6704
1500,1510,132,12.818076848983765,11.715209245454592,10.297956671282178,98252,15.179211469534051,6660
1510,1520,234,14.004956245422363,12.046069526513342,16.708370658172164,98486,15.21536274873316,6700
1520,1530,176,15.684736251831055,12.633735542186049,11.221100385379675,98662,15.242553454455567,6768
1530,1540,180,12.25452709197998,13.54903575507955,14.688449309300696,98842,15.270362130762576,6717
1540,1550,222,12.86840558052063,13.160683156149679,17.25155448442264,99064,15.304659498207885,6679
1550,1560,180,14.207138776779175,13.072999883460964,12.669686896717064,99244,15.332468174514894,6694
1560,1570,139,14.568626165390015,13.413241551456426,9.541050640053873,99383,15.35394265232975,6725
1570,1580,203,13.59209132194519,13.759856935636503,14.935155686619407,99586,15.385304659498209,6710
1580,1590,179,12.935959577560425,13.709527251529108,13.837396362192202,99765,15.412958843159066,6716
1590,1600,200,15.278399467468262,13.477456949338503,13.090376411865176,99965,15.443857372389076,6718
1600,1610,111,12.770061731338501,14.01773970477743,8.692205436062952,100076,15.461006056111728,6710
1610,1620,143,12.53264832496643,13.64343631274575,11.410198091581975,100219,15.483098504511187,6712
1620,1630,185,12.524214029312134,13.310199916411955,14.771386018078193,100404,15.511679644048943,6698
1630,1640,243,14.532896041870117,13.074404150282007,16.720686592672436,100647,15.549221357063402,6690
1640,1650,106,13.303786754608154,13.51195171775844,7.967656273751066,100753,15.565597577555309,6730
1650,1660,233,14.280314922332764,13.449502228813353,16.3161667839422,100986,15.601594364108267,6735
1660,1670,183,12.920030117034912,13.698746036869174,14.164053670332903,101169,15.629866518353728,6700
1670,1680,200,10.802287578582764,13.465131260918895,18.514596889322917,101369,15.660765047583736,6695
1680,1690,155,11.182364225387573,12.666278156218054,13.861111735933266,101524,15.684711407736993,6723
1690,1700,279,10.435795545578003,12.221103976968909,26.734904759438457,101803,15.727814856012854,6651
1700,1710,97,10.617493391036987,11.685511447551637,9.135866294193777,101900,15.742800642689408,6714
1710,1720,164,11.836069345474243,11.365106030597241,13.855951263305894,102064,15.768137436658014,6726
1720,1730,202,10.533884763717651,11.50639502506034,19.17621129630713,102266,15.799344951180325,6723
1730,1740,155,10.712303638458252,11.214641946657533,14.469343404674822,102421,15.823291311333582,6739
1740,1750,139,12.611472368240356,11.063940454197748,11.021710704457126,102560,15.844765789148438,6785
1750,1760,112,12.16920018196106,11.52820002841053,9.20356295609489,102672,15.862068965517242,6741
1760,1770,152,11.507809400558472,11.720500074475689,13.208421751634457,102824,15.88555184773205,6756
1770,1780,184,11.85735535621643,11.656692872300523,15.517794185322675,103008,15.913978494623656,6753
1780,1790,138,11.517390251159668,11.716891617475294,11.981881050362515,103146,15.935298479792362,6692
1790,1800,151,11.516772985458374,11.657041207580605,13.111311666094295,103297,15.958626869361018,6680
1800,1810,162,11.535266876220703,11.614960740943935,14.043888341582612,103459,15.983654678037325,6713
1810,1820,140,12.072293996810913,11.591052581526965,11.596801737679948,103599,16.00528364849833,6698
1820,1830,141,11.495941162109375,11.735425006112148,12.265198474113284,103740,16.027067111605486,6691
1830,1840,152,11.440177917480469,11.663579852911317,13.28650665194163,103892,16.050549993820294,6688
1840,1850,224,12.014037132263184,11.596559272282061,18.644856640109555,104116,16.085156346557905,6685
1850,1860,123,11.721784830093384,11.721802630276397,10.493282531873612,104239,16.104158942034356,6673
1860,1870,208,12.33649730682373,11.721797290221492,16.860539489191005,104447,16.13629341243357,6655
1870,1880,150,10.805784940719604,11.906207295202163,13.881453390281044,104597,16.159467309356074,6725
1880,1890,129,11.966571569442749,11.576080588857396,10.780029956901615,104726,16.17939686070943,6681
1890,1900,148,12.272169351577759,11.693227883033,12.059807501024466,104874,16.20226177233964,6729
1900,1910,101,11.077821016311646,11.866910323596429,9.117316469663264,104975,16.217865529600793,6707
1910,1920,107,11.950231790542603,11.630183531410992,8.953801221218123,105082,16.234396242738846,6727
1920,1930,228,11.174399137496948,11.726198009150474,20.403781643607168,105310,16.269620566061054,6765
1930,1940,149,10.99666976928711,11.560658347654416,13.54955664997289,105459,16.29263997033741,6691
1940,1950,108,9.982280492782593,11.391461774144222,10.819171037929296,105567,16.309325176121618,6706
1950,1960,132,11.894948482513428,10.968707389735734,11.097147683661772,105699,16.32971820541342,6722
1960,1970,158,11.096113681793213,11.246579717569041,14.23921965212473,105857,16.354128043505128,6726
1970,1980,133,11.692087411880493,11.201439906836292,11.37521430645967,105990,16.374675565443084,6648
1980,1990,182,11.357099771499634,11.348634158349551,16.025218027645103,106172,16.40279322704239,6713
1990,2000,146,11.528550624847412,11.351173842294575,12.664211204947751,106318,16.4253491533803,6716
2000,2010,207,13.78068208694458,11.404386877060425,15.021027166435093,106525,16.457329131133356,6693
2010,2020,158,15.040232181549072,12.117275440025672,10.505156974493378,106683,16.481738969225066,6618
2020,2030,172,13.339303970336914,12.994162462482691,12.894225994285948,106855,16.50831170436287,6677
2030,2040,142,13.123486280441284,13.097704914838957,10.820295534703387,106997,16.530249660116176,6774
2040,2050,74,14.524302005767822,13.105439324519654,5.094909206006145,107071,16.54168211593128,6668
2050,2060,134,14.467725276947021,13.531098128894104,9.261995056922775,107205,16.562384130515387,6696
2060,2070,103,12.658785581588745,13.812086273309978,8.136641491882585,107308,16.578296873068844,6673
2070,2080,173,13.365806341171265,13.466096065793607,12.943476479013519,107481,16.6050241008528,6702
2080,2090,136,14.482759237289429,13.436009148406903,9.390475790679066,107617,16.626035100729204,6724
2090,2100,112,13.925872802734375,13.75003417507166,8.042583871512065,107729,16.64333827709801,6690
2100,2110,97,13.727950096130371,13.802785763370473,7.065876501644795,107826,16.658324063774565,6748
2110,2120,159,11.702801942825317,13.780335063198443,13.58648986599989,107985,16.68288839451242,6723
2120,2130,96,10.379143476486206,13.157075127086504,9.249318136654201,108081,16.697719688542826,6748
2130,2140,109,11.809672832489014,12.323695631906414,9.229722240918939,108190,16.71455938697318,6676
2140,2150,152,11.304419040679932,12.169488792081193,13.44606913924677,108342,16.738042269187986,6737
2150,2160,132,11.12366247177124,11.909967866660814,11.866595227514253,108474,16.758435298479792,6753
2160,2170,97,11.209291458129883,11.674076248193941,8.653535360582294,108571,16.773421085156347,6711
2170,2180,135,12.183540344238281,11.534640811174723,11.080523081605165,108706,16.794277592386603,6735
2180,2190,120,13.579095363616943,11.72931067109379,8.83711298777098,108826,16.812816709924608,6722
2190,2200,170,10.707651853561401,12.284246078850735,15.876496763709909,108996,16.839080459770113,6735
2200,2210,140,10.725708723068237,11.811267811263935,13.052750509520742,109136,16.860709430231122,6729
2210,2220,118,11.685415506362915,11.485600084805226,10.098057697284869,109254,16.878939562476827,6643
2220,2230,99,11.03877592086792,11.545544711272532,8.968385689653184,109353,16.894234334445677,6712
2230,2240,114,11.284864902496338,11.393514074151149,10.10202611949585,109467,16.911846496106786,6684
2240,2250,121,11.594493389129639,11.360919322654706,10.435988528264888,109588,16.93054010629094,6670
2250,2260,167,11.858415365219116,11.430991542597184,14.082825981101415,109755,16.956340378198,6616
2260,2270,85,10.9978506565094,11.559218689383762,7.728782891745331,109840,16.969472253120752,6682
2270,2280,143,11.737295389175415,11.390808279521451,12.183385972536747,109983,16.991564701520208,6648
2280,2290,189,11.807126998901367,11.49475441241764,16.0072810276019,110172,17.020763811642567,6690
2290,2300,164,12.21754765510559,11.588466188362757,13.42331576103704,110336,17.046100605611173,6687
2300,2310,167,12.311494827270508,11.777190628385608,13.564559165479043,110503,17.07190087751823,6673
2310,2320,134,10.580322265625,11.937481888051078,12.665020652098669,110637,17.092602892102335,6767
2320,2330,127,11.850785970687866,11.530334001323254,10.716588782729355,110764,17.112223458163392,6687
2330,2340,99,11.58265471458435,11.626469592132636,8.547263338113991,110863,17.127518230132246,6705
2340,2350,128,11.589349746704102,11.61332512886815,11.044623106348306,110991,17.147293288839453,6739
2350,2360,167,10.859479427337646,11.606132514218935,15.378269383668089,111158,17.17309356074651,6695
2360,2370,58,11.149131059646606,11.382136588154548,5.202199139081465,111216,17.18205413422321,6646
2370,2380,154,11.689657211303711,11.312234929602166,13.174039000141464,111370,17.20584600173032,6715
2380,2390,160,11.183796167373657,11.42546161411263,14.306412384979433,111530,17.230564825114325,6672
2390,2400,110,11.091598749160767,11.352961980090937,9.917416099128452,111640,17.24755901619083,6752
2400,2410,228,10.50310730934143,11.274553010811886,21.707861615125793,111868,17.28278333951304,6758
2410,2420,123,11.600355386734009,11.043119300370748,10.603123430223606,111991,17.301785934989493,6727
2420,2430,133,11.667471408843994,11.210290126279725,11.399213706166481,112124,17.32233345692745,6648
2430,2440,97,10.849735260009766,11.347444511049005,8.940310309462122,112221,17.337319243604004,6715
2440,2450,93,11.233147382736206,11.198131735737233,8.27906879802255,112314,17.35168705969596,6696
2450,2460,111,12.474925518035889,11.208636429836925,8.89784871577144,112425,17.36883574341861,6687
2460,2470,148,10.320439100265503,11.588523156296613,14.340475105966428,112573,17.39170065504882,6648
2470,2480,93,11.57814073562622,11.208097939487281,8.03237774730417,112666,17.406068471140774,6695
2480,2490,157,11.163951635360718,11.319110778328962,14.063120759383976,112823,17.43032381658633,6712
2490,2500,120,10.983371019363403,11.272563035438488,10.925607428579355,112943,17.448862934124335,6745
2500,2510,122,19.13333511352539,11.18580543061596,6.37630602694864,113065,17.467711036954643,6729
2510,2520,168,16.447898387908936,13.570064335488789,10.214070882362636,113233,17.49366580150785,6717
2520,2530,102,18.82698965072632,14.433414551214831,5.417754080300617,113335,17.509424051415152,6700
2530,2540,171,14.323465347290039,15.751487081068277,11.938451754089854,113506,17.535842293906807,6655
2540,2550,90,16.232565879821777,15.323080560934804,5.544409963669166,113596,17.549746632060316,6707
2550,2560,124,15.873756647109985,15.595926156600896,7.811635440598476,113720,17.56890372018292,6678
2560,2570,152,17.456960916519165,15.679275303753624,8.707128390037553,113872,17.592386602397724,6727
2570,2580,122,10.765035390853882,16.212580987583287,11.33298642971976,113994,17.611234705228032,6706
2580,2590,47,11.854999303817749,14.578317308564465,3.964572143404872,114041,17.618495859597083,6664
2590,2600,132,11.590487718582153,13.761321907140449,11.388649313555147,114173,17.63888888888889,6693
2600,2610,132,10.833557844161987,13.110071650572959,12.184362874947169,114305,17.659281918180696,6708
2610,2620,88,12.055917024612427,12.427117508649667,7.299320310545105,114393,17.672877271041898,6630
2620,2630,83,11.451010942459106,12.315757363438493,7.248268333431156,114476,17.68570016067235,6701
2630,2640,130,12.030106544494629,12.056333437144676,10.806221833462669,114606,17.705784204671858,6760
2640,2650,114,11.2376229763031,12.04846536934966,10.14449410167907,114720,17.723396366332963,6805
2650,2660,109,11.407734155654907,11.805212651435692,9.55492111866648,114829,17.74023606476332,6653
2660,2670,103,11.072622776031494,11.685969102701456,9.30222243486524,114932,17.75614880731677,6744
2670,2680,96,11.16479206085205,11.501965204700467,8.598458392844773,115028,17.770980101347174,6785
2680,2690,84,10.821051597595215,11.400813261545942,7.762646656140841,115112,17.78395748362378,6705
2690,2700,113,11.99586820602417,11.226884762360722,9.419910093981597,115225,17.801415152638732,6719
2700,2710,47,12.073601961135864,11.457579795459756,3.8927902502741043,115272,17.808676307007786,6680
2710,2720,111,12.431963682174683,11.642386445162588,8.928597511844012,115383,17.82582499073044,6673
2720,2730,75,10.841221809387207,11.879259616266216,6.918039434914885,115458,17.837411939191693,6664
2730,2740,134,11.66260838508606,11.567848274202513,11.48971101279169,115592,17.8581139537758,6657
2740,2750,199,11.338010787963867,11.596276307467576,17.551579701375232,115791,17.888857990359657,6703
2750,2760,118,11.903434991836548,11.518796651616462,9.91310492147226,115909,17.907088122605362,6682
2760,2770,62,11.17434310913086,11.634188153682487,5.548424582500793,115971,17.916666666666668,6711
2770,2780,117,10.781709671020508,11.496234640316999,10.85171123782688,116088,17.934742306266223,6666
2780,2790,56,12.483921766281128,11.28187714952805,4.485769860498093,116144,17.943393894450622,6733
2790,2800,114,10.89272928237915,11.642490534553971,10.465696616954803,116258,17.961006056111728,6688
2800,2810,100,11.455687046051025,11.417562158901525,8.72928874523259,116358,17.976455320726732,6707
2810,2820,79,11.796624422073364,11.428999625046375,6.696830989395441,116437,17.988660239772585,6783
2820,2830,66,12.485695838928223,11.539287064154472,5.286048999706008,116503,17.99885675441849,6673
2830,2840,159,12.146739482879639,11.823209696586595,13.089932506093868,116662,18.023421085156347,6692
2840,2850,101,11.612763166427612,11.920268632474507,8.697327117803455,116763,18.0390248424175,6744
2850,2860,123,11.04221248626709,11.828016992660437,11.139072006898244,116886,18.058027437893955,6696
2860,2870,187,11.780906915664673,11.592275640742432,15.873141290281518,117073,18.086917562724015,6691
2870,2880,67,12.150154829025269,11.648865023219104,5.514333022320423,117140,18.097268570016066,6721
2880,2890,102,12.31675386428833,11.799251964960952,8.28140280498279,117242,18.113026819923373,6734
2890,2900,75,11.105247974395752,11.954502534759165,6.753563736075045,117317,18.124613768384627,6686
2900,2910,95,11.443657398223877,11.699726166650139,8.301541779356707,117412,18.139290569768878,6682
2910,2920,110,12.185456275939941,11.622905536122259,9.027154790846353,117522,18.156284760845384,6786
2920,2930,81,11.027406215667725,11.791670758067562,7.345335649730152,117603,18.168798665183537,6725
2930,2940,80,12.3088858127594,11.56239139534761,6.499369741254074,117683,18.18115807687554,6739
2940,2950,81,11.579307556152344,11.786339720571146,6.995236943763783,117764,18.193671981213694,6689
2950,2960,112,12.085415124893188,11.724230071245504,9.267368877491485,117876,18.2109751575825,6697
2960,2970,31,10.685296297073364,11.832585587339809,2.901183003085343,117907,18.215764429613152,6692
2970,2980,108,12.406625270843506,11.488398800259874,8.705026358280366,118015,18.232449635397355,6712
2980,2990,118,10.885106325149536,11.763866741434963,10.840500448522624,118133,18.25067976764306,6696
2990,3000,110,11.48917555809021,11.500238616549336,9.574229190234844,118243,18.267673958719566,6627
3000,3010,80,12.602919340133667,11.496919699011597,6.347735619099147,118323,18.28003337041157,6730
3010,3020,45,10.758028507232666,11.828719591348218,4.182922546612171,118368,18.28698553948832,6711
3020,3030,164,12.492513418197632,11.507512266113553,13.12786262539482,118532,18.312322333456926,6684
3030,3040,86,20.90673303604126,11.803012611738776,4.113507349605699,118618,18.325608701025832,6651
3040,3050,94,11.099342346191406,14.53412873902952,8.468970238786703,118712,18.340131009763937,6740
3050,3060,85,12.823383092880249,13.503692821178085,6.628515999587767,118797,18.35326288468669,6727
3060,3070,67,11.951501607894897,13.299599902688733,5.605990125604073,118864,18.36361389197874,6672
3070,3080,58,10.853367805480957,12.89517041425058,5.343963370587143,118922,18.372574465455443,6770
3080,3090,49,13.409527778625488,12.282629631619692,3.6541182365948033,118971,18.380144605116797,6659
3090,3100,64,11.746923685073853,12.62069907572143,5.448234935017171,119035,18.3900321344704,6691
3100,3110,86,11.231942176818848,12.358566458527154,7.656734574140875,119121,18.403318502039305,6711
3110,3120,133,11.42409348487854,12.020579174014662,11.642061593424893,119254,18.423866023977258,6746
3120,3130,98,11.479169130325317,11.841633467273825,8.537203249415203,119352,18.439006303299962,6721
3130,3140,94,11.483136892318726,11.732894166189272,8.18591652102295,119446,18.453528612038067,6701
3140,3150,38,11.008288621902466,11.657966984028109,3.4519443762033917,119484,18.45939933259177,6689
3150,3160,46,10.487666368484497,11.463063475390417,4.386104437706971,119530,18.466505994314673,6678
3160,3170,94,12.06411361694336,11.17044434331864,7.791703807230592,119624,18.481028303052774,6737
3170,3180,139,12.032194375991821,11.438545125406055,11.55233996862207,119763,18.50250278086763,6657
3180,3190,107,11.83401370048523,11.616639900581784,9.041733659275101,119870,18.519033494005686,6713
3190,3200,64,11.460066318511963,11.681852040552817,5.584609915966883,119934,18.52892102335929,6671
3200,3210,82,12.106375694274902,11.615316323940561,6.773290542996922,120016,18.54158942034359,6737
3210,3220,84,11.194631814956665,11.762634135040864,7.503596490576065,120100,18.554566802620194,6649
3220,3230,125,11.760925531387329,11.592233439015605,10.628415226880099,120225,18.57387838338895,6696
3230,3240,87,12.024548292160034,11.642841066727122,7.235199018388384,120312,18.587319243604007,6690
3240,3250,136,10.805901527404785,11.757353234356994,12.585715282995238,120448,18.608330243480413,6732
3250,3260,82,11.64881944656372,11.47191772227133,7.039339941369693,120530,18.620998640464713,6716
3260,3270,83,11.480468988418579,11.524988239559047,7.229669805626394,120613,18.63382153009517,6697
3270,3280,134,10.754748821258545,11.511632464216907,12.459612235213413,120747,18.654523544679275,6698
3280,3290,82,10.688319683074951,11.284567371329397,7.671926217724169,120829,18.667191941663578,6647
3290,3300,93,11.74031662940979,11.105693064853062,7.921421792580333,120922,18.68155975775553,6698
3300,3310,112,12.061940670013428,11.29608013422008,9.285404651213172,121034,18.698862934124335,6703
3310,3320,80,12.177157402038574,11.525838294958083,6.569677746516377,121114,18.71122234581634,6676
3320,3330,91,11.101675748825073,11.72123402708223,8.19696071646038,121205,18.725281176615994,6701
3330,3340,59,11.943700790405273,11.535366543605083,4.939842435386228,121264,18.734396242738846,6752
3340,3350,108,12.593269348144531,11.65786681764514,8.576009693297992,121372,18.75108144852305,6703
3350,3360,74,11.215735912322998,11.938487576794957,6.597872897372202,121446,18.762513904338153,6711
3360,3370,108,11.776485443115234,11.721662077453368,9.170817602728743,121554,18.779199110122356,6731
3370,3380,70,11.259236812591553,11.738109087151928,6.217117657718757,121624,18.79001359535286,6725
3380,3390,151,11.892716407775879,11.594447404783816,12.69684694585594,121775,18.813341984921518,6724
3390,3400,72,12.221612930297852,11.683928105681433,5.891202774186148,121847,18.82446545544432,6713
3400,3410,115,10.340417385101318,11.845233553066358,11.121407939073555,121962,18.842232109751574,6630
3410,3420,91,10.851232290267944,11.393788702676844,8.386144316679538,122053,18.85629094055123,6703
3420,3430,113,11.3671133518219,11.231021778954172,9.940958315673749,122166,18.873748609566185,6740
3430,3440,78,10.807199478149414,11.27184925081449,7.217410963654799,122244,18.88579903596589,6699
3440,3450,48,12.39843487739563,11.132454319014968,3.8714563954771286,122292,18.893214682981093,6748
3450,3460,57,11.06395411491394,11.512248486529167,5.151865183819353,122349,18.90202076381164,6722
3460,3470,72,12.055147409439087,11.3777601750446,5.972552433794759,122421,18.913144234334446,6627
3470,3480,81,11.791449069976807,11.580976345362945,6.869384714236766,122502,18.9256581386726,6654
3480,3490,75,11.908041000366211,11.644118162747104,6.2982651804518905,122577,18.937245087133853,6669
3490,3500,66,12.619175672531128,11.723295014032836,5.23013560574055,122643,18.947441601779754,6715
3500,3510,82,12.999706029891968,11.992059211582323,6.307834947301608,122725,18.960109998764057,6711
3510,3520,72,14.972675323486328,12.294353257075215,4.808759853829188,122797,18.97123346928686,6804
3520,3530,78,14.300037622451782,13.097849876998549,5.4545311039976605,122875,18.983283895686565,6690
3530,3540,94,13.12486457824707,13.458506200634519,7.161978658110806,122969,18.99780620442467,6729
3540,3550,108,14.276641368865967,13.358413713918283,7.564804438915365,123077,19.014491410208876,6705
3550,3560,76,12.15744161605835,13.633882010402587,6.251315235568493,123153,19.026232851316276,6732
3560,3570,71,11.509782791137695,13.190949892099315,6.168665498593822,123224,19.03720182919293,6676
3570,3580,69,10.909749984741211,12.686599761810829,6.324617896515137,123293,19.047861821777285,6729
3580,3590,104,11.726987838745117,12.153544828689942,8.868432493499443,123397,19.06392905697689,6678
3590,3600,110,10.283479452133179,12.025577731706495,10.69676859004973,123507,19.08092324805339,6765
3600,3610,105,10.76805830001831,11.5029482478345,9.751061618957008,123612,19.09714497589915,6655
3610,3620,42,12.32890009880066,11.282481263489643,3.406629923466223,123654,19.10363366703745,6715
3620,3630,85,11.208097457885742,11.596406914082948,7.583802721147476,123739,19.116765541960206,6619
3630,3640,59,11.303401470184326,11.479914077223786,5.219667739452404,123798,19.125880608083055,6638
3640,3650,55,12.644347906112671,11.426960295111948,4.349769589415622,123853,19.134377703621308,6772
3650,3660,63,10.696526765823364,11.792176578412164,5.88976229193314,123916,19.14411074032876,6773
3660,3670,96,11.371777534484863,11.463481634635524,8.441951991135989,124012,19.158942034359164,6675
3670,3680,105,12.619114398956299,11.435970404590327,8.320710683840408,124117,19.17516376220492,6658
3680,3690,75,11.063348054885864,11.790913602900119,6.77914132574705,124192,19.18675071066617,6698
3690,3700,67,11.453893661499023,11.572643938495842,5.849539203005959,124259,19.197101717958226,6747
3700,3710,76,10.857978820800781,11.537018855396797,6.999461064927272,124335,19.208843159065626,6662
3710,3720,51,11.806650876998901,11.33330684501799,4.319599226852343,124386,19.21672228401928,6758
3720,3730,107,11.083045482635498,11.475310054612263,9.654386077152134,124493,19.233252997157336,6642
3730,3740,61,11.232444286346436,11.357630683019234,5.430696867479536,124554,19.24267704857249,6722
3740,3750,89,14.09480333328247,11.320074764017393,6.314383953825145,124643,19.25642689407984,6678
3750,3760,137,11.683772563934326,12.152493334796915,11.725664741446097,124780,19.2775923866024,6673
3760,3770,70,10.97180438041687,12.011877103538136,6.379989796841453,124850,19.2884068718329,6730
3770,3780,58,11.681766510009766,11.699855286601755,4.965002506282032,124908,19.297367445309604,6700
3780,3790,90,11.381582975387573,11.694428653624158,7.907511652344235,124998,19.31127178346311,6710
3790,3800,80,11.33477258682251,11.600574950153181,7.057927222378133,125078,19.323631195155112,6709
3800,3810,57,11.567836284637451,11.52083424115398,4.927455627609311,125135,19.332437275985665,6727
3810,3820,65,11.418155670166016,11.53493485419902,5.6926881956808115,125200,19.342479297985417,6715
3820,3830,88,11.952553749084473,11.499901098989119,7.362443361255791,125288,19.35607465084662,6646
3830,3840,67,11.637224197387695,11.635696894017723,5.757386715557138,125355,19.366425658138674,6736
3840,3850,43,11.5120267868042,11.636155085028713,3.7352241092150056,125398,19.373068841923125,6746
3850,3860,74,11.356566190719604,11.59891659556136,6.516054127388573,125472,19.384501297738225,6637
3860,3870,86,10.930796146392822,11.526211474108832,7.867679430503341,125558,19.39778766530713,6700
3870,3880,132,9.947154998779297,11.347586875794029,13.270125982373742,125690,19.418180694598938,6671
3880,3890,81,10.488673210144043,10.927457312689608,7.7226164241308854,125771,19.43069459893709,6632
3890,3900,56,9.5980966091156,10.795822081925937,5.834490137014782,125827,19.439346187121494,6734
3900,3910,58,12.420970916748047,10.436504440082835,4.669522244979627,125885,19.448306760598197,6697
3910,3920,40,10.820314407348633,11.031844383082397,3.6967502508830927,125925,19.454486466444198,6709
3920,3930,71,11.608003854751587,10.968385390362268,6.116469367895417,125996,19.46545544432085,6704
3930,3940,57,11.50557565689087,11.160270929679063,4.954119785033251,126053,19.474261525151405,6684
3940,3950,100,11.715584516525269,11.263862347842604,8.535638990862665,126153,19.489710789766406,6711
3950,3960,32,12.024819374084473,11.399378998447403,2.6611626340904073,126185,19.49465455444321,6687
3960,3970,73,12.636032342910767,11.587011111138523,5.777129878980994,126258,19.505932517612163,6756
3970,3980,63,11.608431100845337,11.901717480670195,5.4270899704450395,126321,19.515665554319614,6700
3980,3990,63,10.579397916793823,11.813731566722737,5.954970263477214,126384,19.52539859102707,6709
3990,4000,50,11.34574580192566,11.443431471744061,4.406938148703608,126434,19.53312322333457,6678
4000,4010,46,15.2820303440094,11.41412577079854,3.0100712382129338,126480,19.54022988505747,6710
4010,4020,71,13.02502179145813,12.574497142761796,5.451046542322265,126551,19.551198862934125,6651
4020,4030,45,13.246550798416138,12.709654537370694,3.397110741113117,126596,19.558151032010876,6747
4030,4040,87,15.100836515426636,12.870723415684326,5.761270238978018,126683,19.571591892225932,6710
4040,4050,38,13.980023384094238,13.539757345607018,2.7181642659649965,126721,19.57746261277963,6686
4050,4060,68,12.475912094116211,13.671837157153183,5.4505032968346745,126789,19.587968112717835,6683
4060,4070,50,11.29744267463684,13.313059638242091,4.425780368175868,126839,19.595692745025335,6695
4070,4080,67,11.509233474731445,12.708374549160514,5.821412880979319,126906,19.60604375231739,6680
4080,4090,66,10.954063177108765,12.348632226831793,6.025161525261548,126972,19.616240266963292,6708
4090,4100,112,12.325400352478027,11.930261511914884,9.086925925086266,127084,19.633543443332098,6642
4100,4110,31,11.188006162643433,12.048803164083825,2.7708243586340244,127115,19.63833271536275,6724
4110,4120,43,11.237427473068237,11.790564063651708,3.8264985561023064,127158,19.6449758991472,6693
4120,4130,51,11.800071477890015,11.624623086476667,4.322007717966754,127209,19.65285502410085,6713
4130,4140,68,10.980054378509521,11.67725760390067,6.1930476531237915,127277,19.663360524039057,6743
4140,4150,81,11.008079290390015,11.468096636283326,7.358231882533087,127358,19.67587442837721,6739
4150,4160,106,12.468663692474365,11.330091432515331,8.501311978121421,127464,19.692250648869113,6743
4160,4170,89,12.474672317504883,11.67166311050304,7.134455938783433,127553,19.706000494376468,6734
4170,4180,69,11.599380493164062,11.912565872603592,5.948593551238725,127622,19.716660486960823,6689
4180,4190,35,10.875269889831543,11.818610258771733,3.218310934308422,127657,19.72206772957607,6682
4190,4200,84,12.51896047592163,11.535608148089675,6.709822286088496,127741,19.735045111852674,6738
4200,4210,23,12.197877645492554,11.830613846439261,1.8855739226486767,127764,19.738598442714128,6673
4210,4220,70,12.022103548049927,11.940792986155248,5.82260830812379,127834,19.74941292794463,6718
4220,4230,42,11.186808824539185,11.965186154723652,3.75442189624887,127876,19.755901619082934,6710
4230,4240,26,11.215254306793213,11.731672955668312,2.3182711054756457,127902,19.759918427882834,6740
4240,4250,97,12.607266902923584,11.576747361005781,7.693975287975066,127999,19.774904214559385,6672
4250,4260,48,11.516432285308838,11.88590322358112,4.1679574724919055,128047,19.78231986157459,6677
4260,4270,54,11.107690334320068,11.775061942099436,4.861496708559933,128101,19.790662464466692,6688
4270,4280,97,11.064615726470947,11.574850459765624,8.766684934926166,128198,19.805648251143246,6665
4280,4290,81,11.737487554550171,11.421780039777222,6.900965783652689,128279,19.8181621554814,6661
4290,4300,73,11.734553813934326,11.516492294209106,6.220943817507176,128352,19.82944011865035,6689
4300,4310,61,12.102081298828125,11.58191075012667,5.04045531456699,128413,19.838864170065502,6690
4310,4320,41,11.774473905563354,11.737961914737106,3.482108867779459,128454,19.845198368557657,6702
4320,4330,66,10.383912086486816,11.748915511984979,6.355986014740013,128520,19.85539488320356,6714
4330,4340,87,11.417352199554443,11.339414484335531,7.619980401707774,128607,19.868835743418614,6635
4340,4350,113,10.984296321868896,11.362795798901205,10.287413657534495,128720,19.886293412433567,6648
4350,4360,88,12.466204404830933,11.249245955791512,7.059085279068426,128808,19.899888765294772,6726
4360,4370,37,11.279717922210693,11.614333490503338,3.2802238721895653,128845,19.905604993202324,6764
4370,4380,44,11.977702140808105,11.513948820015543,3.673492585033629,128889,19.912402669632925,6708
4380,4390,53,11.94495439529419,11.653074816253312,4.4370198701536925,128942,19.92059077987888,6642
4390,4400,73,12.020521640777588,11.740638689965575,6.072947762296757,129015,19.931868743047833,6637
4400,4410,56,12.229526996612549,11.82460357520918,4.579081432627069,129071,19.940520331232232,6654
4410,4420,36,11.620182752609253,11.94608060163019,3.0980579881083523,129107,19.946082066493634,6695
4420,4430,55,12.233826637268066,11.84831124692391,4.49573151808877,129162,19.954579162031887,6630
4430,4440,70,11.713275671005249,11.963965864027156,5.97612503676288,129232,19.965393647262392,6687
4440,4450,61,10.499727249145508,11.888758806120585,5.809674723213817,129293,19.974817698677544,6756
4450,4460,96,12.543395757675171,11.472049339028061,7.653429888892616,129389,19.98964899270795,6767
4460,4470,86,11.90348744392395,11.793453264622194,7.224773446028885,129475,20.00293536027685,6725
4470,4480,45,11.119622945785522,11.826463518412721,4.046899811207679,129520,20.009887529353605,6690
4480,4490,40,11.948404788970947,11.61441134662456,3.3477272243841503,129560,20.016067235199607,6735
4490,4500,38,12.129148244857788,11.714609379328477,3.132948763826865,129598,20.021937955753305,6706
4500,4510,48,13.869802236557007,11.83897103898727,3.460755905623883,129646,20.029353602768506,6664
4510,4520,60,12.497973442077637,12.44822039825819,4.800778324427751,129706,20.03862316153751,6704
4520,4530,76,14.733196496963501,12.463146311404023,5.158418949727816,129782,20.050364602644912,6764
4530,4540,56,13.649728298187256,13.144161367071865,4.102645765296079,129838,20.059016190829315,6694
4540,4550,60,11.45841383934021,13.295831446406481,5.236326846042321,129898,20.06828574959832,6662
4550,4560,75,12.1038498878479,12.744606164286598,6.196375590819163,129973,20.07987269805957,6719
4560,4570,54,11.451542377471924,12.552379281354987,4.7155219986987635,130027,20.088215300951674,6694
4570,4580,106,10.682778358459473,12.222128210190068,9.922512331828056,130133,20.10459152144358,6713
4580,4590,25,10.675633192062378,11.760323254670888,2.3417814709658793,130158,20.10845383759733,6675
4590,4600,57,10.483052968978882,11.434916235888334,5.437347323215154,130215,20.117259918427884,6680
4600,4610,49,13.012064218521118,11.149357255815497,3.7657361028278937,130264,20.124830058089234,6719
4610,4620,66,12.106454610824585,11.708169344627184,5.451637339059471,130330,20.135026572735136,6673
4620,4630,82,11.486680507659912,11.827654924486403,7.138702947759204,130412,20.14769496971944,6675
4630,4640,62,10.598543405532837,11.725362599438455,5.849860459847122,130474,20.157273513780744,6662
4640,4650,29,11.629467964172363,11.387316841266768,2.4936652381125373,130503,20.161753800519094,6679
4650,4660,65,11.09291124343872,11.459962178138447,5.859597951660026,130568,20.17179582251885,6720
4660,4670,86,12.612604141235352,11.34984689772853,6.818576008330716,130654,20.18508219008775,6672
4670,4680,68,11.243860721588135,11.728674070780576,6.047744781242307,130722,20.195587690025953,6671
4680,4690,124,11.76212453842163,11.583230066022843,10.542313133562491,130846,20.21474477814856,6677
4690,4700,82,12.078994750976562,11.636898407742478,6.788644393886376,130928,20.227413175132863,6670
4700,4710,28,11.847691297531128,11.769527310712702,2.363329639238217,130956,20.231738969225066,6673
4710,4720,31,12.045210838317871,11.79297650675823,2.5736369762315583,130987,20.236528241255716,6673
4720,4730,72,12.347137451171875,11.86864680622612,5.831311126545079,131059,20.24765171177852,6642
4730,4740,62,11.649740219116211,12.012193999709845,5.322007086326559,131121,20.257230255839822,6701
4740,4750,73,11.705989122390747,11.903457865531754,6.236124024783905,131194,20.268508219008773,6671
4750,4760,80,11.83722186088562,11.844217242589451,6.758342535113613,131274,20.280867630700776,6625
4760,4770,33,11.320730924606323,11.842118628078302,2.915006126351119,131307,20.28596588802373,6736
4770,4780,155,11.643163681030273,11.685702317036707,13.312532937463992,131462,20.309912248176985,6743
4780,4790,43,10.835205316543579,11.672940726234776,3.968545010803447,131505,20.31655543196144,6688
4790,4800,63,10.905369520187378,11.421620103327417,5.776970682504441,131568,20.326288468668892,6689
4800,4810,70,11.02655577659607,11.266744928385403,6.348310516741358,131638,20.337102953899393,6744
4810,4820,52,12.185694456100464,11.194688182848603,4.267298855008423,131690,20.345136571499197,6634
4820,4830,92,12.431676387786865,11.491990064824162,7.4004500382895015,131782,20.359349894945,6677
4830,4840,49,11.392987489700317,11.773895961712972,4.300891231935243,131831,20.366920034606352,6648
4840,4850,86,11.473586559295654,11.659623420109174,7.4954766371919375,131917,20.380206402175258,6683
4850,4860,39,12.034937143325806,11.603812361865117,3.2405653253974958,131956,20.38623161537511,6683
4860,4870,43,12.62438154220581,11.733149796303323,3.4061074482137976,131999,20.39287479915956,6687
4870,4880,61,12.310036182403564,12.00051932007407,4.955306312356395,132060,20.402298850574713,6684
4880,4890,54,11.41990041732788,12.093374378772918,4.728587643204278,132114,20.410641453466816,6696
4890,4900,114,10.96962857246399,11.891332190339405,10.392329990658327,132228,20.428253615127918,6700
4900,4910,82,12.027079820632935,11.61482110497678,6.81794760015858,132310,20.44092201211222,6731
4910,4920,46,13.481128215789795,11.738498719673625,3.4121773240107918,132356,20.448028673835125,6656
4920,4930,79,11.357429504394531,12.261287568508475,6.955799282701471,132435,20.46023359288098,6697
4930,4940,58,11.222732543945312,11.990130149274291,5.1680818172300755,132493,20.46919416635768,6697
4940,4950,37,12.311052083969116,11.759910867675597,3.0054295723579703,132530,20.474910394265233,6723
4950,4960,65,11.694847583770752,11.925253232563652,5.558003174851309,132595,20.48495241626499,6710
4960,4970,29,12.057104110717773,11.85613153792578,2.4052209994787543,132624,20.489432703003338,6710
4970,4980,39,11.67763066291809,11.916423309763378,3.339718571836934,132663,20.49545791620319,6715
4980,4990,30,10.851620435714722,11.844785515709791,2.7645640738837827,132693,20.50009269558769,6709
4990,5000,30,12.662994861602783,11.54683599171127,2.3691078080563033,132723,20.504727474972192,6713
5000,5010,36,15.543998718261719,11.881683652678722,2.3160063669913806,132759,20.510289210233594,6671
5010,5020,69,14.367861986160278,12.980378172353621,4.802384660046405,132828,20.520949202817945,6677
5020,5030,75,12.502237558364868,13.396623316495617,5.998926164206484,132903,20.5325361512792,6750
5030,5040,45,10.888406038284302,13.128307589056393,4.132836325333318,132948,20.53948832035595,6672
5040,5050,49,11.389076471328735,12.456337123824765,4.30236816157608,132997,20.547058460017304,6670
5050,5060,26,11.023392677307129,12.136158928075954,2.358620504694881,133023,20.551075268817204,6741
5060,5070,46,12.107969760894775,11.802329052845305,3.799150551941964,133069,20.558181930540105,6743
5070,5080,80,11.507889747619629,11.894021265260145,6.9517523850580645,133149,20.57054134223211,6734
5080,5090,26,11.225898027420044,11.77818180996799,2.3160730603906408,133175,20.57455815103201,6667
5090,5100,47,11.328331470489502,11.612496675203605,4.148889898078619,133222,20.581819305401066,6730
5100,5110,70,11.9218909740448,11.527247113789374,5.8715517657725025,133292,20.592633790631567,6726
5110,5120,71,11.270649671554565,11.645640271866,6.299548124470001,133363,20.60360276850822,6714
5120,5130,30,11.906948328018188,11.533143091772569,2.519537262911197,133393,20.60823754789272,6802
5130,5140,38,11.972496747970581,11.645284662646255,3.173941141929419,133431,20.614108268446422,6703
5140,5150,86,10.493186235427856,11.74344828824355,8.195794687188583,133517,20.627394636015325,6681
5150,5160,119,10.697618961334229,11.368369672398842,11.123970710689632,133636,20.645779260907183,6739
5160,5170,69,12.787301778793335,11.167144459079458,5.395978072123918,133705,20.656439253491534,6689
5170,5180,40,10.87968134880066,11.65319165499362,3.676578267102416,133745,20.662618959337536,6702
5180,5190,58,10.375195026397705,11.421138563135731,5.590256361680919,133803,20.67157953281424,6737
5190,5200,62,12.444945335388184,11.107355502114322,4.981942333141321,133865,20.68115807687554,6784
5200,5210,52,11.046386003494263,11.50863245209648,4.707421955339152,133917,20.689191694475344,6699
5210,5220,72,11.08712387084961,11.369958517515814,6.494019624810291,133989,20.700315164998145,6675
5220,5230,69,10.891331195831299,11.285108123515952,6.335313724222254,134058,20.7109751575825,6676
5230,5240,63,10.67985200881958,11.166975045210556,5.898958145484944,134121,20.72070819428995,6709
5240,5250,77,10.70837664604187,11.020838134293262,7.190632394169798,134198,20.732604128043505,6733
5250,5260,62,11.180585384368896,10.927099687817844,5.545326820425662,134260,20.742182672104807,6650
5260,5270,77,11.38343620300293,11.00314539678316,6.764214128918959,134337,20.75407860585836,6740
5270,5280,47,12.961707353591919,11.11723263864909,3.6260655111130453,134384,20.76133976022741,6732
5280,5290,28,12.49427342414856,11.670575053131937,2.2410266727381227,134412,20.765665554319614,6718
5290,5300,51,11.535149812698364,11.917684564436923,4.421268975965715,134463,20.773544679273268,6697
5300,5310,53,10.744534969329834,11.802924138915355,4.932740239692826,134516,20.781732789519218,6684
5310,5320,57,11.441390752792358,11.485407388039697,4.981911834982886,134573,20.79053887034977,6687
5320,5330,34,12.47156047821045,11.472202397465495,2.7262025517498576,134607,20.795791620318873,6707
5330,5340,43,11.201757192611694,11.77200982168898,3.838683454803088,134650,20.802434804103324,6696
5340,5350,64,11.823873281478882,11.600934032965794,5.412777900812816,134714,20.81232233345693,6728
5350,5360,32,11.643062114715576,11.66781580751972,2.748417871923525,134746,20.81726609813373,6684
5360,5370,77,12.023630857467651,11.660389699678477,6.404055556327791,134823,20.829162031887282,6670
5370,5380,32,11.794211387634277,11.769362047015228,2.713195392915428,134855,20.834105796564085,6672
5380,5390,66,11.307128190994263,11.776816849200943,5.837025890673701,134921,20.844302311209987,6690
5390,5400,45,10.799515724182129,11.635910251738938,4.166853509851059,134966,20.851254480286737,6653
5400,5410,66,12.0190749168396,11.384991893471895,5.49127120486862,135032,20.86145099493264,6728
5410,5420,35,11.39870810508728,11.575216800482206,3.07052340294418,135067,20.86685823754789,6699
5420,5430,55,12.820509195327759,11.522264191863728,4.290001213059768,135122,20.875355333086144,6743
5430,5440,25,12.261724948883057,11.911737692902937,2.0388648501104485,135147,20.879217649239894,6669
5440,5450,61,11.563813924789429,12.016733869696973,5.275076233216955,135208,20.88864170065505,6728
5450,5460,98,10.793612241744995,11.880857886224709,9.07944419394451,135306,20.903781979977754,6708
5460,5470,36,10.922785758972168,11.554684192880794,3.2958625019655785,135342,20.909343715239153,6754
5470,5480,86,13.103012561798096,11.365114662708205,6.563376139219577,135428,20.92263008280806,6735
5480,5490,87,11.229411840438843,11.88648403243517,7.74751173402507,135515,20.936070943023115,6682
5490,5500,47,11.228852987289429,11.689362374836271,4.18564568021346,135562,20.943332097392165,6752
5500,5510,50,12.931096076965332,11.551209558572218,3.86664824871783,135612,20.951056729699665,6663
5510,5520,63,14.949074029922485,11.965175514090152,4.214307847689926,135675,20.96078976640712,6713
5520,5530,45,19.433125972747803,12.860345068839852,2.315633628017752,135720,20.967741935483872,6667
5530,5540,74,14.954792499542236,14.832179340012235,4.948246523799319,135794,20.979174391298976,6724
5540,5550,52,15.42069411277771,14.868963287871235,3.372092048496856,135846,20.98720800889878,6695
5550,5560,36,10.91029405593872,15.034482535343177,3.299636088213808,135882,20.992769744160178,6674
5560,5570,27,11.811837196350098,13.79722599152184,2.2858425451667332,135909,20.996941045606228,6691
5570,5580,57,12.848585844039917,13.201609352970316,4.436285883278013,135966,21.005747126436784,6601
5580,5590,37,10.058079481124878,13.095702300291196,3.6786346806499868,136003,21.011463354344333,6715
5590,5600,79,11.690441131591797,12.1844154545413,6.757657740263834,136082,21.023668273390186,6651
5600,5610,42,11.317721605300903,12.036223157656448,3.7109942676384953,136124,21.030156964528487,6724
5610,5620,42,11.453657627105713,11.820672691949783,3.666950887426972,136166,21.036645655666792,6756
5620,5630,22,11.411987066268921,11.710568172496561,1.9277974880489208,136188,21.04004449388209,6628
5630,5640,63,10.832749128341675,11.620993840628268,5.8156982363021195,136251,21.049777530589544,6738
5640,5650,33,12.69791865348816,11.38452042694229,2.5988511109995804,136284,21.054875787912493,6748
5650,5660,15,11.66773247718811,11.77853989490605,1.2855968397738715,136299,21.057193177604745,6681
5660,5670,48,11.372556686401367,11.745297669590668,4.2206868098002595,136347,21.06460882461995,6688
5670,5680,37,11.53743600845337,11.633475374633877,3.206951698184107,136384,21.0703250525275,6691
5680,5690,38,10.993149757385254,11.604663564779724,3.456698110973282,136422,21.076195773081203,6723
5690,5700,57,11.864931583404541,11.421209422561382,4.804073213513156,136479,21.085001853911752,6737
5700,5710,81,11.581212043762207,11.55432607081433,6.9940866028463455,136560,21.09751575824991,6718
5710,5720,21,11.404462814331055,11.562391862698693,1.8413844073050962,136581,21.10076010381906,6761
5720,5730,181,13.055808305740356,11.515013148188402,13.863561394388597,136762,21.128723272772216,6679
5730,5740,38,11.799915075302124,11.977251695453987,3.220362160024025,136800,21.134593993325918,6742
5740,5750,71,12.296504974365234,11.924050709408426,5.773998396130859,136871,21.14556297120257,6683
5750,5760,25,11.77798080444336,12.035786988895468,2.122604919730257,136896,21.149425287356323,6641
5760,5770,105,11.703787088394165,11.958445133559836,8.971455068942705,137001,21.165647015202076,6703
5770,5780,58,10.53713583946228,11.882047720010133,5.50434206065619,137059,21.17460758867878,6697
5780,5790,56,11.698094844818115,11.478574155845775,4.787104288593302,137115,21.18325917686318,6641
5790,5800,80,11.850238561630249,11.544430362537476,6.750918944284471,137195,21.195618588555185,6721
5800,5810,70,12.157302379608154,11.636172822265307,5.757856291985738,137265,21.20643307378569,6675
5810,5820,38,11.125739574432373,11.79251168946816,3.4155032792000912,137303,21.21230379433939,6700
5820,5830,49,13.349820852279663,11.592480054957424,3.670461240057209,137352,21.21987393400074,6752
5830,5840,30,12.123525619506836,12.119682294154096,2.4745277027113133,137382,21.224508713385244,6720
5840,5850,66,11.419997692108154,12.120835291759917,5.779335668833771,137448,21.234705228031146,6692
5850,5860,39,10.207651376724243,11.910584011864389,3.8206633985295415,137487,21.240730441230998,6654
5860,5870,23,11.337785482406616,11.399704221322343,2.028614850377104,137510,21.244283772092448,6715
5870,5880,38,12.402363300323486,11.381128599647624,3.0639321780719695,137548,21.25015449264615,6709
5880,5890,30,11.670040845870972,11.687499009850383,2.5706850898139257,137578,21.254789272030653,6660
5890,5900,28,10.844226598739624,11.68226156065656,2.582019081310447,137606,21.259115066122853,6614
5900,5910,38,11.648884057998657,11.430851072081479,3.2621150498881875,137644,21.264985786676554,6701
5910,5920,115,12.467039108276367,11.496260967856632,9.224323353863237,137759,21.28275244098381,6738
5920,5930,84,12.413636207580566,11.787494409982552,6.766752190522885,137843,21.295729823260412,6711
5930,5940,44,11.309188604354858,11.975336949261955,3.8906416312711247,137887,21.302527499691017,6737
5940,5950,138,12.147386312484741,11.775492445789826,11.36046853619593,138025,21.32384748485972,6719
5950,5960,32,11.490339517593384,11.8870606057983,2.7849481689382056,138057,21.328791249536522,6705
5960,5970,65,12.432841539382935,11.768044279336825,5.228088831833215,138122,21.338833271536277,6666
5970,5980,64,12.753498792648315,11.967483457350658,5.018230764791576,138186,21.34872080088988,6682
5980,5990,33,11.30298113822937,12.203288057939954,2.919583744892412,138219,21.353819058212828,6729
5990,6000,30,11.12199354171753,11.933195982026778,2.6973581568333844,138249,21.35845383759733,6667
6000,6010,35,12.877798318862915,11.689835249934003,2.7178558891338835,138284,21.363861080212583,6686
6010,6020,74,13.877809762954712,12.046224170612675,5.332253522997186,138358,21.375293536027684,6705
6020,6030,45,13.08846926689148,12.595699848315284,3.4381407850214964,138403,21.382245705104435,6714
6030,6040,24,14.142080783843994,12.743530673888142,1.6970628556596676,138427,21.38595352861204,6722
6040,6050,56,12.194401502609253,13.163095706874898,4.592271296628835,138483,21.39460511679644,6688
6050,6060,69,13.024008750915527,12.872487445595205,5.29790798821059,138552,21.405265109380796,6709
6060,6070,50,12.577008485794067,12.9179438371913,3.9755081708401327,138602,21.412989741688296,6656
6070,6080,25,11.732274293899536,12.815663231772131,2.130874148842507,138627,21.416852057842046,6681
6080,6090,70,11.750506162643433,12.490646550410352,5.957190186627039,138697,21.427666543072547,6701
6090,6100,59,11.885560512542725,12.268604434080276,4.964006530254744,138756,21.436781609195403,6726
6100,6110,22,10.900699853897095,12.153691257619009,2.0182190405081935,138778,21.440180447410704,6742
6110,6120,74,11.888147354125977,11.777793836502433,6.224687312133382,138852,21.451612903225804,6727
6120,6130,81,11.163587808609009,11.810899891789497,7.25573188375294,138933,21.46412680756396,6701
6130,6140,16,11.152486085891724,11.61670626683535,1.4346576966583753,138949,21.466598689902362,6647
6140,6150,100,11.431507110595703,11.477440212552262,8.747752945655906,139049,21.482047954517363,6640
6150,6160,41,11.200355291366577,11.463660281965293,3.6605981625961,139090,21.488382153009518,6735
6160,6170,54,11.419894218444824,11.384668784785678,4.728590209949755,139144,21.49672475590162,6732
6170,6180,69,12.822208881378174,11.39523641488342,5.381288094612888,139213,21.507384748485972,6624
6180,6190,77,11.31889796257019,11.823328154831845,6.802782413502344,139290,21.519280682239526,6704
6190,6200,30,11.340379476547241,11.67199909715335,2.6454141205805555,139320,21.52391546162403,6645
6200,6210,26,11.648800611495972,11.572513210971518,2.2319894439897197,139346,21.52793227042393,6738
6210,6220,33,11.813085794448853,11.595399431128854,2.7935122604042375,139379,21.53303052774688,6700
6220,6230,88,11.416332960128784,11.660705340124853,7.708254507584658,139467,21.546625880608083,6707
6230,6240,59,11.763264417648315,11.587393626126032,5.015614535662639,139526,21.555740946730936,6727
6240,6250,33,11.392814874649048,11.640154863582717,2.8965624705647257,139559,21.560839204053885,6722
6250,6260,38,11.270025730133057,11.565952866902617,3.3717757980266265,139597,21.56670992460759,6735
6260,6270,49,11.588598489761353,11.477174725871748,4.2282938737839615,139646,21.57428006426894,6698
6270,6280,29,13.01224398612976,11.51060185503863,2.22867016872049,139675,21.578760351007293,6693
6280,6290,72,10.877920627593994,11.96109449436597,6.618912057269271,139747,21.589883821530094,6670
6290,6300,34,11.693276166915894,11.636142334334377,2.9076538956804194,139781,21.595136571499197,6648
6300,6310,46,11.318232536315918,11.653282484108832,4.064238815769462,139827,21.602243233222097,6687
6310,6320,111,11.279541015625,11.552767499770956,9.840825956148135,139938,21.619391916944753,6706
6320,6330,61,10.721981048583984,11.470799554527169,5.689247138527265,139999,21.62881596835991,6759
6330,6340,45,11.961609840393066,11.246154002744213,3.7620354283785327,140044,21.63576813743666,6713
6340,6350,38,10.48135495185852,11.460790754038868,3.625485461997636,140082,21.64163885799036,6723
6350,6360,48,11.694682598114014,11.166960013384763,4.104429478722312,140130,21.64905450500556,6760
6360,6370,54,11.170333862304688,11.325276788803539,4.834233306331867,140184,21.657397107897662,6775
6370,6380,28,9.68480110168457,11.278793910853883,2.8911280372221264,140212,21.661722901989865,6739
6380,6390,47,12.122672080993652,10.80059606810309,3.8770330242363182,140259,21.668984056358916,6654
6390,6400,103,11.567052602767944,11.197218871970257,8.904602022416027,140362,21.684896798912373,6737
6400,6410,45,11.292362928390503,11.308168991209563,3.9849941314641963,140407,21.691848967989124,6666
6410,6420,50,11.445777177810669,11.303427172363845,4.368423325323193,140457,21.699573600296628,6701
6420,6430,22,10.76143479347229,11.34613217399789,2.044337063060108,140479,21.702972438511928,6685
6430,6440,64,12.335355997085571,11.170722959840209,5.188338302933539,140543,21.71285996786553,6639
6440,6450,40,11.168943166732788,11.520112871013817,3.5813594359707945,140583,21.71903967371153,6693
6450,6460,86,11.235817193984985,11.414761959729507,7.654093913706561,140669,21.732326041280437,6723
6460,6470,66,12.354861974716187,11.36107853000615,5.3420264941095095,140735,21.74252255592634,6699
6470,6480,52,11.263214111328125,11.65921356341916,4.616799386571221,140787,21.75055617352614,6795
6480,6490,80,13.030422925949097,11.540413727791847,6.139478392576659,140867,21.762915585218142,6683
6490,6500,78,11.661394834518433,11.987416487239022,6.688736734058201,140945,21.774966011617845,6734
6500,6510,32,13.04762077331543,11.889609991422844,2.4525544201472624,140977,21.779909776294648,6666
6510,6520,49,11.942127227783203,12.23701322599062,4.103121585072561,141026,21.787479915956002,6697
6520,6530,78,11.81276535987854,12.148547426528394,6.603026270624409,141104,21.799530342355705,6660
6530,6540,36,12.821932077407837,12.047812806533436,2.8076891830858917,141140,21.805092077617104,6680
6540,6550,63,10.57096242904663,12.280048587795754,5.9597222507281025,141203,21.814825114324556,6651
6550,6560,66,11.911048173904419,11.767322740171016,5.54107405464093,141269,21.82502162897046,6674
6560,6570,46,11.896005153656006,11.810440370291037,3.8668443234376704,141315,21.832128290693362,6685
6570,6580,59,11.756072759628296,11.836109805300527,5.018682786875289,141374,21.841243356816214,6698
6580,6590,57,12.444631814956665,11.812098691598857,4.580288179477851,141431,21.850049437646767,6680
6590,6600,62,10.83429479598999,12.0018586286062,5.722569042790635,141493,21.859627981708073,6731
6600,6610,44,11.589343070983887,11.651589478821336,3.7965913797273227,141537,21.86642565813867,6735
6610,6620,90,11.630407810211182,11.6329155564701,7.738335703154145,141627,21.88032999629218,6767
6620,6630,56,11.347938060760498,11.632163232592424,4.934817206452665,141683,21.88898158447658,6739
6630,6640,77,12.053936243057251,11.546895681042846,6.387954809728645,141760,21.900877518230132,6702
6640,6650,58,11.168864250183105,11.699007849647167,5.19300787446218,141818,21.909838091706835,6731
6650,6660,31,11.174556732177734,11.539964769807948,2.7741592568709095,141849,21.914627363737484,6639
6660,6670,67,11.55528473854065,11.430342358518883,5.798212810501598,141916,21.92497837102954,6678
6670,6680,51,11.796905279159546,11.467825072525413,4.323167711628301,141967,21.93285749598319,6711
6680,6690,24,12.111146211624146,11.566549134515652,1.9816456329265568,141991,21.936565319490793,6696
6690,6700,44,11.211398839950562,11.7299282576482,3.9245771761513772,142035,21.943362995921394,6642
6700,6710,49,11.6337149143219,11.574369432338909,4.21189623098617,142084,21.950933135582744,6616
6710,6720,65,10.881749868392944,11.592173076933806,5.973303998541499,142149,21.9609751575825,6711
6720,6730,56,11.289847373962402,11.379046114371548,4.960208773871639,142205,21.969626745766902,6730
6730,6740,37,12.266371011734009,11.352286492248803,3.016377049463595,142242,21.975342973674454,6699
6740,6750,52,11.403517723083496,11.626511848094363,4.559996420643022,142294,21.983376591274258,6644
6750,6760,77,10.405708074569702,11.559613610591104,7.399784757385106,142371,21.995272525027808,6697
6760,6770,59,12.07151174545288,11.213441949784682,4.887540288582681,142430,22.00438759115066,6680
6770,6780,55,11.969233512878418,11.470862888485142,4.595114627918504,142485,22.012884686688913,6723
6780,6790,55,11.825690269470215,11.620374075803124,4.650891300780193,142540,22.021381782227166,6690
6790,6800,46,13.130517482757568,11.681968933903251,3.5032891933166552,142586,22.028488443950067,6649
6800,6810,13,11.787089586257935,12.116533498559546,1.1029016030518803,142599,22.03049684835002,6732
6810,6820,62,11.56933879852295,12.017700324869063,5.358992512857823,142661,22.04007539241132,6737
6820,6830,23,12.125343322753906,11.883191866965227,1.8968535065592058,142684,22.043628723272775,6690
6830,6840,42,12.058120012283325,11.955837303701829,3.4831300366239164,142726,22.050117414411076,6699
6840,6850,37,11.550983190536499,11.986522116276277,3.2031905327603107,142763,22.055833642318625,6729
6850,6860,17,11.498404741287231,11.855860438554343,1.4784659596264023,142780,22.058460017303176,6627
6860,6870,42,12.051042079925537,11.74862372937421,3.485175781600085,142822,22.064948708441477,6686
6870,6880,42,11.6109778881073,11.839349234539608,3.6172663839984627,142864,22.07143739957978,6753
6880,6890,41,11.164707899093628,11.770837830609914,3.672285954147395,142905,22.077771598071934,6692
6890,6900,15,12.136184453964233,11.588998851155026,1.2359733042043797,142920,22.08008898776418,6636
6900,6910,27,11.467670202255249,11.753154531997788,2.3544451073148354,142947,22.084260289210235,6688
6910,6920,24,12.495397329330444,11.667509233075027,1.9207072306268167,142971,22.087968112717835,6706
6920,6930,58,11.076904058456421,11.915875661951652,5.236120101240848,143029,22.096928686194538,6730
6930,6940,55,11.339799165725708,11.664184180903082,4.8501740812338445,143084,22.10542578173279,6713
6940,6950,13,13.227031946182251,11.56686867634987,0.9828357603500172,143097,22.10743418613274,6678
6950,6960,41,11.524088144302368,12.064917657299583,3.5577652206930432,143138,22.11376838462489,6671
6960,6970,12,11.007024765014648,11.902668803400417,1.0902128646191003,143150,22.115622296378692,6781
6970,6980,35,10.263695478439331,11.633975591884685,3.410077790550544,143185,22.121029538993945,6745
6980,6990,63,11.325143575668335,11.222891557851078,5.562843382873595,143248,22.130762575701397,6675
6990,7000,37,12.223317623138428,11.253567163196255,3.027001436169829,143285,22.13647880360895,6643
7000,7010,24,13.272583723068237,11.544492301178906,1.8082387348807694,143309,22.14018662711655,6724
7010,7020,103,13.371418476104736,12.062919727745705,7.702997268694054,143412,22.156099369670006,6704
7020,7030,46,13.892586469650269,12.455469352253413,3.3111184947807635,143458,22.163206031392907,6744
7030,7040,14,13.475418090820312,12.886604487472468,1.038928803963199,143472,22.165368928439005,6721
7040,7050,87,11.441563844680786,13.063248568476821,7.603855660032569,143559,22.17880978865406,6731
7050,7060,31,11.948074579238892,12.576743151338011,2.5945603029517366,143590,22.18359906068471,6726
7060,7070,45,10.438943147659302,12.388142579708274,4.310781212568462,143635,22.190551229761464,6704
7070,7080,44,12.60839056968689,11.803382750093581,3.4897396108417564,143679,22.197348906192065,6730
7080,7090,28,10.874993801116943,12.044885095971573,2.5747141112967062,143707,22.201674700284265,6707
7090,7100,53,12.60457992553711,11.693917707515183,4.204820812205017,143760,22.20986281053022,6641
7100,7110,30,11.444318771362305,11.96711637292176,2.6213880091378186,143790,22.21449758991472,6726
7110,7120,29,11.966556787490845,11.810277092453923,2.4234205807902023,143819,22.21897787665307,6695
7120,7130,35,11.32022500038147,11.857161000965,3.091811337567987,143854,22.224385119268323,6722
7130,7140,52,10.85287618637085,11.696080200789941,4.791356605109171,143906,22.232418736868127,6681
7140,7150,27,12.326951265335083,11.443118996464214,2.1903226044161745,143933,22.236590038314176,6705
7150,7160,51,10.397022247314453,11.708268677125474,4.90525063685165,143984,22.244469163267826,6667
7160,7170,35,11.496190547943115,11.314894748182168,3.0444867675111875,144019,22.24987640588308,6663
7170,7180,41,11.824449300765991,11.369283488110451,3.4673919230508274,144060,22.25621060437523,6738
7180,7190,68,11.052032709121704,11.505833231907111,6.152714327734188,144128,22.266716104313435,6712
7190,7200,21,11.48180890083313,11.369693075071488,1.8289801007292694,144149,22.269960449882586,6712
7200,7210,29,11.75714898109436,11.40332782279998,2.466584377439833,144178,22.27444073662094,6698
7210,7220,47,11.016079664230347,11.509474170288293,4.266490569472812,144225,22.28170189098999,6677
7220,7230,69,11.596955299377441,11.361455818470908,5.949837540867655,144294,22.29236188357434,6720
7230,7240,36,11.723001480102539,11.432105662742867,3.070885904186128,144330,22.297923618835743,6724
7240,7250,75,11.387189865112305,11.51937440795077,6.586348422079316,144405,22.309510567296996,6671
7250,7260,27,10.344885110855103,11.479719045099229,2.6099854866119623,144432,22.31368186874305,6691
7260,7270,28,12.252516508102417,11.13926886482599,2.2852448296220613,144460,22.31800766283525,6735
7270,7280,81,11.025300741195679,11.473243157808916,7.346738370350853,144541,22.330521567173403,6680
7280,7290,24,11.881141901016235,11.338860432824944,2.020007857826123,144565,22.334229390681003,6669
7290,7300,10,11.094974040985107,11.50154487328233,0.901309003793948,144575,22.335774317142505,6658
7300,7310,56,12.468839406967163,11.379573623593163,4.491195866129217,144631,22.344425905326908,6801
7310,7320,22,11.472766160964966,11.706353358605362,1.91758462530623,144653,22.34782474354221,6613
7320,7330,31,11.47346544265747,11.636277199313241,2.7018863790485095,144684,22.352614015572858,6729
7330,7340,48,11.196528673171997,11.58743367231651,4.287043011376625,144732,22.36002966258806,6683
7340,7350,33,11.084456443786621,11.470162172573156,2.9771419254841414,144765,22.365127919911014,6673
7350,7360,16,12.776915550231934,11.354450453937195,1.2522584137851298,144781,22.367599802249412,6637
7360,7370,42,11.529378890991211,11.781189982825616,3.6428675297346524,144823,22.374088493387713,6599
7370,7380,47,12.731489658355713,11.705646655275293,3.6916339926611625,144870,22.381349647756767,6715
7380,7390,63,11.853185176849365,12.013399556199419,5.315027063193634,144933,22.39108268446422,6717
7390,7400,39,12.162958145141602,11.965335242394403,3.206456812118378,144972,22.39710789766407,6717
7400,7410,51,12.279271602630615,12.024622113218562,4.153340821052786,145023,22.40498702261772,6615
7410,7420,23,11.261929988861084,12.101016960042177,2.042278723340384,145046,22.408540353479175,6769
7420,7430,27,10.877983570098877,11.849290868687849,2.4820776595229384,145073,22.412711654925225,6645
7430,7440,42,11.09504771232605,11.557898679111156,3.785472680152612,145115,22.419200346063526,6648
7440,7450,23,11.084574937820435,11.419043389075624,2.0749555241423177,145138,22.422753676924977,6686
7450,7460,32,11.833133697509766,11.318702853699067,2.704270974875765,145170,22.42769744160178,6702
7460,7470,34,11.89592695236206,11.473032106842275,2.8581211145760226,145204,22.43295019157088,6722
7470,7480,31,11.120862007141113,11.59990056049821,2.78755369683517,145235,22.437739463601535,6699
7480,7490,16,11.26236605644226,11.456188994491079,1.420660624935711,145251,22.440211345939932,6697
7490,7500,19,11.856365203857422,11.398042113076434,1.6025147398309243,145270,22.443146706216783,6737
7500,7510,22,13.645321607589722,11.53553904031073,1.612274201566879,145292,22.446545544432084,6716
7510,7520,34,12.8910813331604,12.168473810494426,2.6374823896688966,145326,22.451798294401186,6733
7520,7530,16,12.99238395690918,12.385256067294218,1.2314906989406982,145342,22.454270176739588,6643
7530,7540,36,13.153536796569824,12.567394434178706,2.736906472895417,145378,22.45983191200099,6675
7540,7550,58,13.244040727615356,12.74323714289604,4.379328121444333,145436,22.46879248547769,6712
7550,7560,58,14.522016048431396,12.893478218311834,3.993935814873645,145494,22.477753058954395,6691
7560,7570,58,15.427128553390503,13.382039567347702,3.7596108568922912,145552,22.486713632431098,6664
7570,7580,22,11.366528511047363,13.99556626316054,1.93550739600202,145574,22.490112470646398,6688
7580,7590,55,10.83756971359253,13.206854937526586,5.074938519751227,145629,22.498609566184648,6757
7590,7600,62,11.868403434753418,12.496069370346369,5.223954539533913,145691,22.508188110245953,6716
7600,7610,23,12.004569053649902,12.307769589668483,1.9159371650252632,145714,22.511741441107404,6735
7610,7620,43,11.340125799179077,12.21680942886291,3.791845060758745,145757,22.518384624891855,6717
7620,7630,19,11.857363224029541,11.95380433995776,1.6023798580695874,145776,22.521319985168706,6634
7630,7640,31,11.202630043029785,11.924872005179292,2.7672073326466786,145807,22.526109257199355,6697
7640,7650,21,11.843390941619873,11.70819941653444,1.7731408262647232,145828,22.52935360276851,6653
7650,7660,39,11.532533407211304,11.748756874060069,3.381737439894452,145867,22.53537881596836,6677
7660,7670,30,11.94471001625061,11.683889834005438,2.5115720648877553,145897,22.54001359535286,6665
7670,7680,37,11.124343395233154,11.762135888678989,3.3260390016236565,145934,22.545729823260412,6640
7680,7690,32,11.931794166564941,11.570798140645238,2.681910159803948,145966,22.550673587937215,6757
7690,7700,34,12.477886199951172,11.679096948421149,2.7248204908402713,146000,22.555926337906314,6715
7700,7710,16,11.868764400482178,11.918733723880155,1.3480763001201699,146016,22.558398220244715,6748
7710,7720,24,10.89326786994934,11.903742926860762,2.203195614624284,146040,22.562106043752316,6745
7720,7730,21,10.026396989822388,11.600600409787335,2.0944712264352505,146061,22.565350389321466,6665
7730,7740,32,11.0727858543396,11.12833938379785,2.8899682899095076,146093,22.57029415399827,6725
7740,7750,50,9.999948740005493,11.111673324960375,5.000025630128634,146143,22.578018786305773,6705
7750,7760,20,11.82677674293518,10.77815594947391,1.6910778341991752,146163,22.581108639228773,6755
7760,7770,70,10.89475965499878,11.09274218751229,6.425107319176362,146233,22.591923124459274,6683
7770,7780,20,12.061618089675903,11.033347427758237,1.6581523184786398,146253,22.595012977382275,6713
7780,7790,31,12.03743577003479,11.341828626333536,2.575299307280159,146284,22.599802249412928,6755
7790,7800,74,10.93453335762024,11.55051076944391,6.767549888027883,146358,22.611234705228032,6671
7800,7810,32,12.60690712928772,11.365717545896809,2.5382910869279938,146390,22.61617846990483,6699
7810,7820,45,10.989043951034546,11.738074420914081,4.094987716903575,146435,22.623130638981586,6670
7820,7830,37,10.734929323196411,11.51336527995022,3.4466924640154923,146472,22.628846866889134,6653
7830,7840,48,11.973749160766602,11.279834492924078,4.008769463559305,146520,22.636262513904338,6713
7840,7850,108,11.390718460083008,11.488008893276834,9.481403686560169,146628,22.652947719688544,6742
7850,7860,36,13.173246622085571,11.458821763318685,2.7328115105386623,146664,22.658509454949943,6695
7860,7870,24,12.347347259521484,11.97314922094875,1.9437373466185406,146688,22.662217278457543,6788
7870,7880,38,11.518562078475952,12.08540863252057,3.299022893752366,146726,22.668087999011245,6715
7880,7890,9,11.437787055969238,11.915354666307184,0.7868654973168968,146735,22.669478432826597,6727
7890,7900,24,12.029533624649048,11.772084383205799,1.9950898138580315,146759,22.673186256334198,6677
7900,7910,27,12.327527284622192,11.849319155638772,2.1902202588252053,146786,22.67735755778025,6736
7910,7920,59,11.420188665390015,11.992781594333799,5.166289430822207,146845,22.686472623903104,6672
7920,7930,35,10.518351316452026,11.821003715650663,3.3275176828573496,146880,22.691879866518352,6650
7930,7940,53,10.680927991867065,11.430207995891072,4.9621156551524885,146933,22.700067976764306,6659
7940,7950,20,12.423399209976196,11.20542399468387,1.6098653566521204,146953,22.703157829687306,6731
7950,7960,47,11.506911039352417,11.570816559271567,4.084501899707487,147000,22.71041898405636,6738
7960,7970,15,11.125580549240112,11.551644903295822,1.3482442496921667,147015,22.71273637374861,6724
7970,7980,26,11.298786401748657,11.423825597079109,2.3011320929100942,147041,22.71675318254851,6699
7980,7990,38,11.893258333206177,11.386313838479973,3.1950874130013105,147079,22.722623903102214,6661
7990,8000,67,10.493615865707397,11.538397186897834,6.384834441953664,147146,22.732974910394265,6672
8000,8010,21,13.414020776748657,11.224962790540703,1.5655261274382835,147167,22.736219255963416,6706
8010,8020,16,15.335416078567505,11.881680186403088,1.0433365432035004,147183,22.738691138301817,6644
8020,8030,48,13.021187782287598,12.917800954052414,3.686299652731621,147231,22.746106785317018,6744
8030,8040,20,11.722455263137817,12.948817002522969,1.706127219174943,147251,22.74919663824002,6644
8040,8050,39,12.337178945541382,12.580908480707421,3.161176487116974,147290,22.75522185143987,6689
8050,8060,108,11.649457931518555,12.50778962015761,9.270817632449424,147398,22.771907057224077,6688
8060,8070,83,11.308344602584839,12.250290113565892,7.339712656176752,147481,22.78472994685453,6688
8070,8080,53,9.925759077072144,11.967706460271575,5.339641994981174,147534,22.79291805710048,6660
8080,8090,40,11.35314416885376,11.355122245311744,3.523253065854311,147574,22.79909776294648,6702
8090,8100,21,11.215739488601685,11.354528822374348,1.8723687387124006,147595,22.802342108515635,6690
8100,8110,34,11.514248609542847,11.312892022242549,2.9528631136052836,147629,22.807594858484737,6738
8110,8120,38,12.918431282043457,11.373298998432638,2.941533625125194,147667,22.81346557903844,6756
8120,8130,43,11.100764989852905,11.836838683515882,3.873606912614208,147710,22.820108762822887,6684
8130,8140,30,11.34700608253479,11.616016575416989,2.6438692093569713,147740,22.82474354220739,6688
8140,8150,50,11.661906003952026,11.535313427552328,4.287463814496175,147790,22.832468174514894,6730
8150,8160,28,11.873135566711426,11.573291200472237,2.3582649960220516,147818,22.836793968607093,6742
8160,8170,35,13.09254264831543,11.663244510343993,2.673277524477136,147853,22.842201211222346,6688
8170,8180,20,12.173415899276733,12.092033951735424,1.6429242346996682,147873,22.845291064145346,6674
8180,8190,22,11.060088157653809,12.116448535997817,1.9891342353157961,147895,22.848689902360647,6754
8190,8200,31,12.600396871566772,11.799540422494614,2.4602399683102494,147926,22.8534791743913,6697
8200,8210,31,11.701151847839355,12.03979735721626,2.6493118287089166,147957,22.85826844642195,6699
8210,8220,27,11.902191638946533,11.938203704403188,2.268489772223982,147984,22.862439747868002,6779
8220,8230,25,11.354060411453247,11.927400084766191,2.2018554679153906,148009,22.866302064021752,6649
8230,8240,31,10.779940605163574,11.755398182772307,2.875711577218807,148040,22.871091336052405,6742
8240,8250,54,11.457879066467285,11.462760909489687,4.712914116717884,148094,22.87943393894451,6654
8250,8260,41,11.506640672683716,11.461296356582965,3.563159845369317,148135,22.885768137436656,6700
8260,8270,42,11.53602385520935,11.474899651413189,3.6407691703094005,148177,22.89225682857496,6710
8270,8280,34,11.417281866073608,11.493236912552037,2.9779417201769203,148211,22.89750957854406,6622
8280,8290,42,11.446663856506348,11.470450398608508,3.669191349244257,148253,22.90399826968236,6766
8290,8300,18,10.494950294494629,11.463314435977859,1.7151105526857349,148271,22.906779137313062,6641
8300,8310,30,10.76833176612854,11.17280519353289,2.785946853380213,148301,22.911413916697565,6770
8310,8320,34,12.594396114349365,11.051463165311585,2.6996133590924827,148335,22.916666666666664,6715
8320,8330,27,12.132503509521484,11.514343050022918,2.2254269268342375,148362,22.920837968112718,6761
8330,8340,28,11.435847759246826,11.699791187872487,2.448441129111717,148390,22.92516376220492,6693
8340,8350,70,10.762861967086792,11.620608159284789,6.503846301667943,148460,22.935978247435422,6730
8350,8360,27,12.636701345443726,11.36328430162539,2.136633545568052,148487,22.94014954888147,6758
8360,8370,30,11.84309458732605,11.74530941477089,2.533121708924343,148517,22.944784328265975,6731
8370,8380,66,11.756019353866577,11.774644966537437,5.614145231760993,148583,22.954980842911876,6747
8380,8390,24,11.485571384429932,11.769057282736178,2.0895782366156266,148607,22.958688666419476,6712
8390,8400,19,11.124921321868896,11.684011513244304,1.7078772469743773,148626,22.961624026696327,6708
8400,8410,29,11.251445531845093,11.516284455831682,2.5774465972324156,148655,22.96610431343468,6716
8410,8420,42,13.027942895889282,11.436832778635704,3.223839737066417,148697,22.972593004572982,6711
8420,8430,37,11.534851551055908,11.914165813811778,3.2076702362600407,148734,22.978309232480534,6689
8430,8440,21,11.32759952545166,11.800371534985015,1.8538790988166292,148755,22.981553578049684,6707
8440,8450,51,12.20827579498291,11.658539932125008,4.1774940914227106,148806,22.989432703003338,6704
8450,8460,67,11.098909139633179,11.823460690982378,6.036629290057812,148873,22.99978371029539,6664
8460,8470,107,11.622875213623047,11.606095225577619,9.205983720326486,148980,23.016314423433446,6701
8470,8480,52,12.618612051010132,11.611129221991247,4.120896956796239,149032,23.024348041033246,6720
8480,8490,21,10.501009464263916,11.913374070696912,1.9998077395763996,149053,23.027592386602397,6679
8490,8500,14,11.738010168075562,11.489664688767013,1.1927064127169085,149067,23.029755283648498,6781
8500,8510,28,12.61734414100647,11.564168332559577,2.2191674957172465,149095,23.0340810777407,6750
8510,8520,33,14.369151830673218,11.880121075093644,2.296586492290819,149128,23.03917933506365,6637
8520,8530,18,12.085057020187378,12.626830301767516,1.4894427034917632,149146,23.04196020269435,6740
8530,8540,30,11.346517324447632,12.464298317293473,2.6439830956200874,149176,23.04659498207885,6719
8540,8550,52,10.908915519714355,12.128964019439719,4.766743303312481,149228,23.054628599678654,6795
8550,8560,22,11.983724117279053,11.762949469522109,1.8358233037323275,149250,23.05802743789396,6659
8560,8570,54,11.011888027191162,11.829181863849191,4.90379123604056,149304,23.066370040786058,6748
8570,8580,26,12.766513109207153,11.58399371285178,2.03657802076347,149330,23.07038684958596,6730
8580,8590,34,11.245969295501709,11.938749531758392,3.023305426736289,149364,23.07563959955506,6741
8590,8600,70,11.722931623458862,11.730915460881388,5.971202617946042,149434,23.086454084785565,6704
8600,8610,20,11.413084745407104,11.72852030965463,1.7523746161657543,149454,23.089543937708566,6739
8610,8620,24,11.357778310775757,11.633889640380373,2.1130893158241926,149478,23.093251761216166,6684
8620,8630,27,12.51933479309082,11.551056241498987,2.1566641076569644,149505,23.097423062662216,6654
8630,8640,29,12.033048868179321,11.841539806976536,2.410029271690965,149534,23.10190334940057,6709
8640,8650,25,11.496063470840454,11.898992525337372,2.1746574436903576,149559,23.10576566555432,6748
8650,8660,29,10.521795272827148,11.778113808988296,2.756183640532654,149588,23.110245952292672,6673
8660,8670,20,11.445639371871948,11.401218248139951,1.7473903685232899,149608,23.11333580521567,6681
8670,8680,38,12.297896146774292,11.41454458525955,3.089959416348406,149646,23.11920652576937,6678
8680,8690,23,11.041398763656616,11.679550053713973,2.0830694092587065,149669,23.122759856630825,6740
8690,8700,38,11.843652725219727,11.488104666696765,3.2084696234872943,149707,23.128630577184524,6685
8700,8710,12,11.358469247817993,11.594769084253652,1.0564803881742468,149719,23.130484488938325,6696
8710,8720,56,11.729562044143677,11.523879133322954,4.774261800163257,149775,23.13913607712273,6639
8720,8730,44,12.759446144104004,11.58558400656917,3.448425543167632,149819,23.14593375355333,6764
8730,8740,39,10.487664222717285,11.93774264782962,3.718654523237144,149858,23.151958966753185,6630
8740,8750,47,10.869800329208374,11.50271912029592,4.323906472661299,149905,23.159220121122235,6804
8750,8760,10,11.024096727371216,11.312843482969656,0.9071037970096422,149915,23.160765047583734,6747
8760,8770,40,10.971198320388794,11.226219456290124,3.645909847939244,149955,23.166944753429735,6761
8770,8780,41,13.12752890586853,11.149713115519724,3.123207748693005,149996,23.173278951921887,6707
8780,8790,76,12.245242834091187,11.743057852624364,6.206491862163266,150072,23.185020393029294,6672
8790,8800,8,12.129140853881836,11.89371334706441,0.659568562718081,150080,23.186256334198493,6703
8800,8810,25,11.792243957519531,11.964341599109638,2.120037550958086,150105,23.190118650352243,6737
8810,8820,26,12.107863187789917,11.912712306632605,2.1473648650258537,150131,23.194135459152143,6661
8820,8830,45,12.541361808776855,11.971257570979798,3.5881270858885137,150176,23.201087628228898,6658
8830,8840,25,12.043704748153687,12.142288842318916,2.0757732377848708,150201,23.204949944382648,6636
8840,8850,39,11.489199161529541,12.112713614069346,3.39449246650608,150240,23.2109751575825,6727
8850,8860,39,12.249656915664673,11.925659278307403,3.183762636660248,150279,23.21700037078235,6664
8860,8870,41,11.517133712768555,12.022858569514584,3.5599135186339854,150320,23.223334569274503,6663
8870,8880,20,12.579896688461304,11.871141112490776,1.5898381755666293,150340,23.226424422197503,6689
8880,8890,26,11.748769283294678,12.083767785281934,2.212997750919225,150366,23.230441230997403,6709
8890,8900,10,11.280718326568604,11.983268234685756,0.8864683711185105,150376,23.231986157458905,6695
8900,8910,67,11.360939502716064,11.772503262250611,5.897399593051462,150443,23.24233716475096,6685
8910,8920,31,10.823314189910889,11.649034134390245,2.8641873880827653,150474,23.24712643678161,6720
8920,8930,23,11.824265241622925,11.401318151046437,1.9451525765031945,150497,23.25067976764306,6729
8930,8940,20,10.871985673904419,11.528202278219384,1.8395903563417288,150517,23.25376962056606,6651
8940,8950,72,11.44629979133606,11.331337296924893,6.290242376361511,150589,23.264893091088865,6603
8950,8960,21,11.456072807312012,11.365826045248243,1.8330889086700315,150610,23.268137436658016,6694
8960,8970,21,10.51302981376648,11.392900073867374,1.99752120673159,150631,23.271381782227166,6670
8970,8980,21,11.45193362236023,11.128938995837105,1.83375146001518,150652,23.274626127796317,6727
8980,8990,17,12.15472412109375,11.225837383794042,1.3986331430178314,150669,23.27725250278087,6641
8990,9000,31,11.72845721244812,11.504503404983954,2.643143888276953,150700,23.282041774811518,6670
9000,9010,12,17.806600332260132,11.571689547223203,0.6739074150083358,150712,23.28389568656532,6647
9010,9020,18,18.935214042663574,13.44216278273428,0.9506097982015724,150730,23.28667655419602,6731
9020,9030,20,17.169792652130127,15.09007816071307,1.1648364313542685,150750,23.28976640711902,6688
9030,9040,48,12.090852737426758,15.713992508138187,3.969943315198761,150798,23.297182054134225,6681
9040,9050,8,10.772721290588379,14.627050576924757,0.7426164461331812,150806,23.298417995303424,6665
9050,9060,17,11.382484912872314,13.470751791023844,1.4935227351608351,150823,23.301044370287975,6709
9060,9070,45,11.776040315628052,12.844271727578384,3.8213184392957826,150868,23.307996539364726,6702
9070,9080,41,10.870173692703247,12.523802303993284,3.7717888562831163,150909,23.314330737856878,6684
9080,9090,31,10.995087623596191,12.027713720606272,2.8194409231875452,150940,23.319120009887527,6616
9090,9100,50,11.659148931503296,11.717925891503247,4.288477683383803,150990,23.326844642195034,6693
9100,9110,18,12.166387557983398,11.700292803503261,1.479485994853803,151008,23.329625509825732,6682
9110,9120,17,13.024280309677124,11.840121229847302,1.305254462879526,151025,23.332251884810283,6703
9120,9130,16,11.149211406707764,12.195368953796248,1.4350790756711125,151041,23.33472376714868,6687
9130,9140,64,10.46594762802124,11.881521689669702,6.115069774345914,151105,23.344611296502286,6739
9140,9150,11,11.187476396560669,11.456849471175163,0.9832422979128426,151116,23.346310715609935,6669
9150,9160,33,10.83636212348938,11.376037548790814,3.0453024385801704,151149,23.351408972932887,6686
9160,9170,8,11.97298288345337,11.214134921200383,0.6681710044917861,151157,23.35264491410209,6679
9170,9180,14,11.822428226470947,11.441789309876278,1.1841898916039406,151171,23.35480781114819,6657
9180,9190,18,12.360973834991455,11.555980984854678,1.4561959470414527,151189,23.35758867877889,6650
9190,9200,18,10.538411140441895,11.79747883989571,1.7080373654168544,151207,23.36036954640959,6631
9200,9210,40,12.430627584457397,11.419758530059566,3.217858449078942,151247,23.36654925225559,6742
9210,9220,46,11.437952995300293,11.723019246378914,4.021698639511878,151293,23.373655913978496,6684
9220,9230,29,12.477169513702393,11.637499371055329,2.324245091657389,151322,23.378136200716845,6814
9230,9240,38,11.72278881072998,11.889400413849447,3.2415494822544475,151360,23.384006921270547,6716
9240,9250,38,11.716185331344604,11.839416932913608,3.243376485206123,151398,23.38987764182425,6698
9250,9260,11,11.624412775039673,11.802447452442905,0.9462843597243524,151409,23.3915770609319,6703
9260,9270,37,12.322551012039185,11.749037049221934,3.002625021706207,151446,23.397293288839453,6693
9270,9280,47,11.57809329032898,11.92109123806711,4.059390334957695,151493,23.404554443208504,6665
9280,9290,35,12.248058557510376,11.81819185374567,2.8575957434934356,151528,23.409961685823756,6685
9290,9300,16,11.472418308258057,11.947151864875082,1.3946492857990462,151544,23.412433568162154,6737
9300,9310,36,12.261064767837524,11.804731797889973,2.936123467387025,151580,23.41799530342356,6727
9310,9320,30,11.809957504272461,11.941631688874237,2.540229292878232,151610,23.42263008280806,6658
9320,9330,44,12.656419038772583,11.902129433493704,3.4764967772643462,151654,23.42942775923866,6652
9330,9340,19,11.075567245483398,12.128416315077367,1.7154877559655624,151673,23.43236311951551,6711
9340,9350,19,11.447986125946045,11.812561594199174,1.6596805578701614,151692,23.435298479792362,6743
9350,9360,18,11.248530387878418,11.703188953723235,1.6002090388089332,151710,23.438079347423063,6721
9360,9370,22,11.345185995101929,11.566791383969788,1.9391484643352772,151732,23.441478185638363,6658
9370,9380,17,12.579349040985107,11.500309767309428,1.3514212813883972,151749,23.444104560622915,6669
9380,9390,50,11.232863426208496,11.82402154941213,4.451224777053738,151799,23.451829192930415,6704
9390,9400,26,12.015693426132202,11.646674112451038,2.1638368322092987,151825,23.45584600173032,6714
9400,9410,21,11.972646236419678,11.757379906555386,1.7539982043501754,151846,23.45909034729947,6711
9410,9420,16,11.737236022949219,11.821959805514673,1.3631829477328408,151862,23.46156222963787,6680
9420,9430,9,12.686383724212646,11.796542670745035,0.7094220225124529,151871,23.462952663453223,6664
9430,9440,6,12.39335560798645,12.063494986785319,0.4841303832299879,151877,23.46387961933012,6646
9440,9450,51,11.770858526229858,12.162453173145657,4.3327340895613515,151928,23.471758744283772,6643
9450,9460,26,12.140716314315796,12.044974779070916,2.1415540341175707,151954,23.475775553083672,6712
9460,9470,22,12.329295873641968,12.07369723964438,1.7843679173141125,151976,23.479174391298972,6688
9470,9480,24,11.996819734573364,12.150376829843657,2.0005301847484582,152000,23.482882214806576,6701
9480,9490,53,11.287974834442139,12.104309701262569,4.695262062268702,152053,23.491070325052526,6691
9490,9500,14,12.061103820800781,11.859409241216438,1.1607561138687295,152067,23.493233222098628,6753
9500,9510,29,13.10368275642395,11.91991761509174,2.213118291938428,152096,23.497713508836977,6691
9510,9520,22,14.956411600112915,12.2750471574914,1.4709410644886176,152118,23.50111234705228,6596
9520,9530,5,15.36027193069458,13.079456490277853,0.32551507047270767,152123,23.50188481028303,6652
9530,9540,17,11.335383415222168,13.76370112240287,1.4997287147050427,152140,23.50451118526758,6664
9540,9550,13,11.920480489730835,13.035205810248659,1.0905600668697157,152153,23.506519589667533,6715
9550,9560,58,12.889055728912354,12.700788214093311,4.499941750573402,152211,23.515480163144233,6632
9560,9570,26,12.645257472991943,12.757268468539023,2.0561068096502937,152237,23.519496971944136,6757
9570,9580,35,12.048866987228394,12.723665169874899,2.904837445470968,152272,23.524904214559385,6693
9580,9590,29,10.500083208084106,12.521225715080945,2.7618828751445172,152301,23.529384501297738,6698
9590,9600,34,11.8618803024292,11.914882962981892,2.8663246579074926,152335,23.53463725126684,6683
9600,9610,27,11.242457628250122,11.898982164816085,2.4016101187834784,152362,23.538808552712894,6718
9610,9620,26,11.43837833404541,11.702024803846296,2.273049486622863,152388,23.542825361512794,6697
9620,9630,15,11.321943998336792,11.62293086290603,1.3248608191493898,152403,23.54514275120504,6796
9630,9640,26,11.201229333877563,11.532634803535258,2.321173794858774,152429,23.54915956000494,6761
9640,9650,18,12.480026721954346,11.433213162637948,1.4423046040706904,152447,23.551940427635646,6712
9650,9660,21,11.43484377861023,11.747257230432867,1.8364920768993926,152468,23.555184773204797,6730
9660,9670,53,10.891411781311035,11.653533194886075,4.866219463939891,152521,23.563372883450747,6730
9670,9680,47,11.937968254089355,11.424896770813563,3.937018343460591,152568,23.570634037819797,6725
9680,9690,22,10.989564418792725,11.5788182157963,2.0018991801330053,152590,23.5740328760351,6654
9690,9700,43,10.873910427093506,11.402042076695228,3.9544191841842764,152633,23.580676059819552,6671
9700,9710,37,11.776767015457153,11.243602581814711,3.1417790596890502,152670,23.586392287727104,6672
9710,9720,40,11.071533679962158,11.403551911907442,3.6128689264066547,152710,23.592571993573106,6656
9720,9730,8,11.457683563232422,11.303946442323857,0.6982214123692428,152718,23.593807934742305,6705
9730,9740,45,11.672197341918945,11.350067578596427,3.8553152145902514,152763,23.600760103819056,6704
9740,9750,21,10.870611906051636,11.44670650759318,1.9318139752840744,152784,23.604004449388206,6702
9750,9760,31,11.999630212783813,11.273878127130716,2.5834129427566968,152815,23.60879372141886,6719
9760,9770,41,11.383960008621216,11.491603752826645,3.601558681596754,152856,23.61512791991101,6677
9770,9780,14,10.894318103790283,11.459310629565017,1.2850735462854905,152870,23.617290816957112,6692
9780,9790,12,10.880370855331421,11.289812871832597,1.1029035829343958,152882,23.619144728710914,6712
9790,9800,24,11.953958511352539,11.166980266882243,2.0077031367649028,152906,23.622852552218514,6696
9800,9810,14,11.138172626495361,11.40307374022333,1.2569386801113995,152920,23.625015449264616,6749
9810,9820,33,11.519951343536377,11.323603406104938,2.864595432385716,152953,23.630113706587565,6668
9820,9830,38,12.171985864639282,11.382507787334369,3.1219227842182624,152991,23.635984427141267,6711
9830,9840,28,11.98239803314209,11.619351210525842,2.336760965756175,153019,23.640310221233467,6729
9840,9850,46,11.226518392562866,11.728265257310715,4.097441289587448,153065,23.64741688295637,6709
9850,9860,22,11.43021535873413,11.57774119788636,1.9247231403377905,153087,23.65081572117167,6669
9860,9870,21,12.048196792602539,11.53348344614069,1.7429994182111774,153108,23.654060066740822,6687
9870,9880,35,10.933103084564209,11.687897450079245,3.2012869291806454,153143,23.659467309356074,6710
9880,9890,20,12.444931983947754,11.461459140424733,1.6070798961213482,153163,23.662557162279075,6683
9890,9900,17,11.478884220123291,11.75650099348164,1.4809801783868335,153180,23.665183537263626,6740
9900,9910,45,12.021360397338867,11.673215961474135,3.7433367366609787,153225,23.672135706340377,6767
9910,9920,56,11.22661805152893,11.777659292233555,4.988145115738882,153281,23.68078729452478,6758
9920,9930,22,11.390397787094116,11.612346920022166,1.9314514217341108,153303,23.68418613274008,6700
9930,9940,24,12.75173544883728,11.54576218014375,1.8820967621460771,153327,23.68789395624768,6721
9940,9950,49,10.535296201705933,11.90755416075181,4.651032022437646,153376,23.695464095909035,6677
9950,9960,24,12.225841045379639,11.495876773038045,1.9630551314152758,153400,23.699171919416635,6718
9960,9970,9,9.765519618988037,11.714866054740522,0.9216099451073179,153409,23.700562353231984,6600
9970,9980,32,10.718302726745605,11.130062124014776,2.985547321792818,153441,23.705506117908786,6651
9980,9990,11,12.458876132965088,11.006534304834023,0.8829046763612145,153452,23.70720553701644,6680
9990,10000,45,11.52266550064087,11.442236853273343,3.905346379923741,153497,23.71415770609319,6680
